"StartTime","EndTime","director","trial","target","pair","peaks1","peaks2","psum","round"
5570,54720,"B","1.1_ref",9,"003004",43,91,134,1
82620,103290,"A","1.2_ref",6,"003004",50,18,68,1
124670,173300,"B","1.3_ref",15,"003004",28,84,112,1
183260,197730,"A","1.4_ref",14,"003004",38,12,50,1
207190,223010,"B","1.5_ref",13,"003004",12,42,54,1
249440,271890,"A","1.6_ref",16,"003004",56,27,83,1
282110,314310,"B","1.7_ref",11,"003004",40,75,115,1
352860,385380,"A","1.8_ref",8,"003004",77,31,108,1
421800,439450,"B","1.9_ref",3,"003004",21,36,57,1
445210,467490,"A","1.10_ref",10,"003004",63,16,79,1
481280,523680,"B","1.11_ref",5,"003004",30,73,103,1
537290,561910,"A","1.12_ref",4,"003004",68,20,88,1
580800,593790,"B","1.13_ref",7,"003004",10,35,45,1
608610,623410,"A","1.14_ref",2,"003004",41,21,62,1
634380,646390,"B","1.15_ref",1,"003004",12,30,42,1
667250,698570,"A","1.16_ref",12,"003004",89,20,109,1
708800,721770,"B","2.1_ref",14,"003004",7,31,38,2
726380,741210,"A","2.2_ref",9,"003004",31,17,48,2
752540,873510,"B","2.3_ref",16,"003004",104,239,343,2
885050,899070,"A","2.4_ref",3,"003004",37,8,45,2
920010,932330,"B","2.5_ref",10,"003004",12,20,32,2
945520,960790,"A","2.6_ref",11,"003004",49,14,63,2
970850,983940,"B","2.7_ref",12,"003004",20,23,43,2
1037160,1054410,"A","2.8_ref",7,"003004",46,11,57,2
1073270,1080180,"B","2.9_ref",6,"003004",6,11,17,2
1120860,1130000,"A","2.10_ref",13,"003004",22,9,31,2
1135350,1148520,"B","2.11_ref",2,"003004",9,32,41,2
1161780,1182000,"A","2.12_ref",15,"003004",66,21,87,2
1191400,1205160,"B","2.13_ref",8,"003004",14,29,43,2
1234630,1243800,"A","2.14_ref",1,"003004",13,9,22,2
1259060,1285640,"B","2.15_ref",4,"003004",22,42,64,2
1311650,1340350,"A","2.16_ref",5,"003004",70,25,95,2
1347240,1365930,"B","3.1_ref",9,"003004",19,27,46,3
1372160,1381130,"A","3.2_ref",10,"003004",21,4,25,3
1393330,1405890,"B","3.3_ref",15,"003004",10,15,25,3
1409660,1417750,"A","3.4_ref",12,"003004",10,6,16,3
1434770,1441220,"B","3.5_ref",1,"003004",2,16,18,3
1453780,1459810,"A","3.6_ref",4,"003004",9,3,12,3
1465290,1484250,"B","3.7_ref",7,"003004",23,26,49,3
1489680,1496090,"A","3.8_ref",16,"003004",12,5,17,3
1512830,1519370,"B","3.9_ref",13,"003004",10,16,26,3
1535390,1540310,"A","3.10_ref",2,"003004",10,3,13,3
1553110,1560590,"B","3.11_ref",11,"003004",7,13,20,3
1568710,1573180,"A","3.12_ref",6,"003004",5,1,6,3
1586610,1592610,"B","3.13_ref",5,"003004",5,5,10,3
1599740,1618130,"A","3.14_ref",8,"003004",37,18,55,3
1624340,1645310,"B","3.15_ref",3,"003004",32,20,52,3
1652410,1674960,"A","3.16_ref",14,"003004",27,36,63,3
1703770,1711900,"B","4.1_ref",10,"003004",5,18,23,4
1730500,1740600,"A","4.2_ref",15,"003004",12,5,17,4
1751300,1756660,"B","4.3_ref",6,"003004",7,14,21,4
1773610,1777550,"A","4.4_ref",1,"003004",4,2,6,4
1787090,1793530,"B","4.5_ref",16,"003004",4,6,10,4
1807230,1811600,"A","4.6_ref",13,"003004",5,1,6,4
1826290,1832600,"B","4.7_ref",12,"003004",5,5,10,4
1839260,1855640,"A","4.8_ref",7,"003004",34,13,47,4
1868330,1874900,"B","4.9_ref",2,"003004",5,14,19,4
1889590,1900730,"A","4.10_ref",9,"003004",27,14,41,4
1920730,1929860,"B","4.11_ref",14,"003004",17,9,26,4
1937960,1946960,"A","4.12_ref",5,"003004",5,10,15,4
2014890,2021270,"B","4.13_ref",8,"003004",8,7,15,4
2070630,2080360,"A","4.14_ref",11,"003004",12,10,22,4
2091190,2101270,"B","4.15_ref",4,"003004",5,3,8,4
2118640,2129230,"A","4.16_ref",3,"003004",24,9,33,4
2132960,2140590,"B","5.1_ref",7,"003004",5,16,21,5
2168380,2173950,"A","5.2_ref",6,"003004",4,5,9,5
2190260,2197870,"B","5.3_ref",11,"003004",5,10,15,5
2213970,2221280,"A","5.4_ref",10,"003004",17,9,26,5
2229900,2257830,"B","5.5_ref",9,"003004",51,48,99,5
2269140,2273580,"A","5.6_ref",4,"003004",5,2,7,5
2287790,2290670,"B","5.7_ref",13,"003004",5,5,10,5
2304360,2311970,"A","5.8_ref",12,"003004",8,5,13,5
2321680,2328650,"B","5.9_ref",1,"003004",4,14,18,5
2351550,2354410,"A","5.10_ref",8,"003004",3,0,3,5
2374980,2381510,"B","5.11_ref",15,"003004",7,13,20,5
2397970,2404040,"A","5.12_ref",14,"003004",8,2,10,5
2416250,2422610,"B","5.13_ref",5,"003004",6,6,12,5
2431160,2436150,"A","5.14_ref",16,"003004",6,2,8,5
2448310,2455760,"B","5.15_ref",3,"003004",10,9,19,5
2464080,2469290,"A","5.16_ref",2,"003004",11,2,13,5
2471080,2481060,"B","6.1_ref",10,"003004",4,18,22,6
2492250,2495140,"A","6.2_ref",11,"003004",3,0,3,6
2507830,2513830,"B","6.3_ref",8,"003004",6,2,8,6
2520950,2527190,"A","6.4_ref",7,"003004",16,5,21,6
2553570,2566430,"B","6.5_ref",4,"003004",5,7,12,6
2578640,2584140,"A","6.6_ref",3,"003004",7,5,12,6
2593360,2598860,"B","6.7_ref",14,"003004",3,4,7,6
2621640,2627020,"A","6.8_ref",13,"003004",7,4,11,6
2634640,2641210,"B","6.9_ref",2,"003004",2,5,7,6
2651510,2661230,"A","6.10_ref",9,"003004",9,10,19,6
2667250,2676080,"B","6.11_ref",6,"003004",7,3,10,6
2702370,2708040,"A","6.12_ref",1,"003004",6,5,11,6
2725910,2730160,"B","6.13_ref",16,"003004",1,7,8,6
2744650,2750550,"A","6.14_ref",5,"003004",9,2,11,6
2755270,2763060,"B","6.15_ref",12,"003004",7,7,14,6
2770390,2772780,"A","6.16_ref",15,"003004",2,0,2,6
24120,101920,"B","1.1_ref",9,"005006",74,118,192,1
128210,156660,"A","1.2_ref",6,"005006",48,14,62,1
175180,199240,"B","1.3_ref",15,"005006",19,42,61,1
230870,252620,"A","1.4_ref",14,"005006",31,14,45,1
271900,287040,"B","1.5_ref",13,"005006",14,29,43,1
308260,326510,"A","1.6_ref",16,"005006",34,3,37,1
345610,363650,"B","1.7_ref",11,"005006",7,32,39,1
388320,433910,"A","1.8_ref",8,"005006",82,35,117,1
501500,512850,"B","1.9_ref",3,"005006",5,27,32,1
521360,543220,"A","1.10_ref",10,"005006",41,12,53,1
587000,632260,"B","1.11_ref",5,"005006",43,75,118,1
653660,680240,"A","1.12_ref",4,"005006",22,25,47,1
715320,724810,"B","1.13_ref",7,"005006",5,10,15,1
731850,753780,"A","1.14_ref",2,"005006",55,6,61,1
766010,780010,"B","1.15_ref",1,"005006",3,22,25,1
839730,862720,"A","1.16_ref",12,"005006",48,14,62,1
905350,920300,"B","2.1_ref",14,"005006",3,23,26,2
935100,954840,"A","2.2_ref",9,"005006",46,18,64,2
979370,995570,"B","2.3_ref",16,"005006",16,33,49,2
1011040,1026570,"A","2.4_ref",3,"005006",37,5,42,2
1048760,1060640,"B","2.5_ref",10,"005006",2,24,26,2
1074920,1093160,"A","2.6_ref",11,"005006",40,8,48,2
1116020,1126020,"B","2.7_ref",12,"005006",4,22,26,2
1145580,1155190,"A","2.8_ref",7,"005006",10,5,15,2
1169840,1186690,"B","2.9_ref",6,"005006",10,32,42,2
1200320,1210300,"A","2.10_ref",13,"005006",20,5,25,2
1218170,1231480,"B","2.11_ref",2,"005006",13,25,38,2
1248510,1273870,"A","2.12_ref",15,"005006",47,22,69,2
1279790,1299330,"B","2.13_ref",8,"005006",13,46,59,2
1309050,1318340,"A","2.14_ref",1,"005006",24,4,28,2
1322910,1334300,"B","2.15_ref",4,"005006",6,24,30,2
1359630,1375870,"A","2.16_ref",5,"005006",27,16,43,2
1383340,1401480,"B","3.1_ref",9,"005006",9,38,47,3
1407030,1421140,"A","3.2_ref",10,"005006",20,3,23,3
1458450,1468030,"B","3.3_ref",15,"005006",4,19,23,3
1475100,1489300,"A","3.4_ref",12,"005006",13,5,18,3
1529770,1539310,"B","3.5_ref",1,"005006",3,22,25,3
1550890,1558680,"A","3.6_ref",4,"005006",16,1,17,3
1563460,1570810,"B","3.7_ref",7,"005006",5,7,12,3
1577480,1589060,"A","3.8_ref",16,"005006",21,4,25,3
1604140,1610970,"B","3.9_ref",13,"005006",2,13,15,3
1620430,1627630,"A","3.10_ref",2,"005006",16,1,17,3
1634810,1646420,"B","3.11_ref",11,"005006",3,26,29,3
1654190,1667120,"A","3.12_ref",6,"005006",29,2,31,3
1673580,1683180,"B","3.13_ref",5,"005006",3,23,26,3
1688190,1702840,"A","3.14_ref",8,"005006",23,6,29,3
1708420,1716780,"B","3.15_ref",3,"005006",1,11,12,3
1725290,1735100,"A","3.16_ref",14,"005006",18,3,21,3
1739220,1751890,"B","4.1_ref",10,"005006",3,20,23,4
1772640,1786380,"A","4.2_ref",15,"005006",19,5,24,4
1793310,1809030,"B","4.3_ref",6,"005006",10,20,30,4
1817730,1824360,"A","4.4_ref",1,"005006",14,1,15,4
1829260,1841820,"B","4.5_ref",16,"005006",3,26,29,4
1856120,1862850,"A","4.6_ref",13,"005006",19,1,20,4
1870820,1880570,"B","4.7_ref",12,"005006",3,26,29,4
1884840,1897620,"A","4.8_ref",7,"005006",13,7,20,4
1901700,1908160,"B","4.9_ref",2,"005006",1,14,15,4
1916930,1930590,"A","4.10_ref",9,"005006",26,3,29,4
1935810,1942940,"B","4.11_ref",14,"005006",3,13,16,4
1953040,1964070,"A","4.12_ref",5,"005006",5,12,17,4
1968340,1976940,"B","4.13_ref",8,"005006",1,16,17,4
1982530,1992470,"A","4.14_ref",11,"005006",23,1,24,4
1997560,2008260,"B","4.15_ref",4,"005006",2,21,23,4
2012510,2020060,"A","4.16_ref",3,"005006",15,1,16,4
2026150,2035110,"B","5.1_ref",7,"005006",3,6,9,5
2103020,2114470,"A","5.2_ref",6,"005006",25,8,33,5
2122400,2133220,"B","5.3_ref",11,"005006",2,16,18,5
2144040,2156050,"A","5.4_ref",10,"005006",20,4,24,5
2171210,2200440,"B","5.5_ref",9,"005006",16,49,65,5
2207200,2216060,"A","5.6_ref",4,"005006",10,2,12,5
2223400,2229150,"B","5.7_ref",13,"005006",2,7,9,5
2235460,2241300,"A","5.8_ref",12,"005006",9,1,10,5
2244490,2258880,"B","5.9_ref",1,"005006",8,17,25,5
2267920,2295200,"A","5.10_ref",8,"005006",36,15,51,5
2300160,2308910,"B","5.11_ref",15,"005006",2,10,12,5
2316160,2323460,"A","5.12_ref",14,"005006",16,2,18,5
2331450,2340150,"B","5.13_ref",5,"005006",2,10,12,5
2350510,2358510,"A","5.14_ref",16,"005006",18,3,21,5
2364690,2373790,"B","5.15_ref",3,"005006",1,13,14,5
2382630,2394200,"A","5.16_ref",2,"005006",4,10,14,5
2397100,2406870,"B","6.1_ref",10,"005006",2,10,12,6
2423550,2433120,"A","6.2_ref",11,"005006",14,1,15,6
2508880,2519470,"B","6.3_ref",8,"005006",4,17,21,6
2527080,2533090,"A","6.4_ref",7,"005006",10,1,11,6
2552570,2561230,"B","6.5_ref",4,"005006",3,12,15,6
2572070,2583960,"A","6.6_ref",3,"005006",22,2,24,6
2593980,2602070,"B","6.7_ref",14,"005006",1,12,13,6
2608500,2614170,"A","6.8_ref",13,"005006",11,1,12,6
2620690,2627950,"B","6.9_ref",2,"005006",1,8,9,6
2635540,2644980,"A","6.10_ref",9,"005006",17,3,20,6
2650410,2659450,"B","6.11_ref",6,"005006",2,22,24,6
2669990,2676370,"A","6.12_ref",1,"005006",14,1,15,6
2685480,2692290,"B","6.13_ref",16,"005006",3,15,18,6
2696200,2703710,"A","6.14_ref",5,"005006",5,6,11,6
2706710,2713820,"B","6.15_ref",12,"005006",2,11,13,6
2723690,2735830,"A","6.16_ref",15,"005006",17,4,21,6
1560,145860,"B","1.1_ref",9,"007008",214,191,405,1
165390,207550,"A","1.2_ref",6,"007008",52,52,104,1
226890,252310,"B","1.3_ref",15,"007008",26,37,63,1
275620,292760,"A","1.4_ref",14,"007008",22,15,37,1
309500,334780,"B","1.5_ref",13,"007008",23,25,48,1
384810,473120,"A","1.6_ref",16,"007008",149,68,217,1
499270,527570,"B","1.7_ref",11,"007008",16,44,60,1
539550,592010,"A","1.8_ref",8,"007008",68,69,137,1
607770,632570,"B","1.9_ref",3,"007008",32,44,76,1
668900,698160,"A","1.10_ref",10,"007008",44,35,79,1
723560,758070,"B","1.11_ref",5,"007008",41,50,91,1
771590,796690,"A","1.12_ref",4,"007008",50,16,66,1
808860,876430,"B","1.13_ref",7,"007008",87,107,194,1
898740,926600,"A","1.14_ref",2,"007008",29,22,51,1
944220,962350,"B","1.15_ref",1,"007008",19,34,53,1
983920,1012810,"A","1.16_ref",12,"007008",39,22,61,1
1035180,1060060,"B","2.1_ref",14,"007008",16,32,48,2
1076130,1093680,"A","2.2_ref",9,"007008",22,7,29,2
1113250,1131770,"B","2.3_ref",16,"007008",10,26,36,2
1139170,1152560,"A","2.4_ref",3,"007008",28,8,36,2
1170300,1187140,"B","2.5_ref",10,"007008",7,16,23,2
1213060,1239380,"A","2.6_ref",11,"007008",50,17,67,2
1250050,1259310,"B","2.7_ref",12,"007008",6,13,19,2
1299700,1308350,"A","2.8_ref",7,"007008",10,3,13,2
1338030,1349010,"B","2.9_ref",6,"007008",6,14,20,2
1378220,1388190,"A","2.10_ref",13,"007008",14,3,17,2
1402140,1418440,"B","2.11_ref",2,"007008",7,14,21,2
1447330,1458840,"A","2.12_ref",15,"007008",22,5,27,2
1478370,1496670,"B","2.13_ref",8,"007008",14,19,33,2
1505250,1536600,"A","2.14_ref",1,"007008",41,18,59,2
1546860,1554300,"B","2.15_ref",4,"007008",3,14,17,2
1577380,1589310,"A","2.16_ref",5,"007008",19,4,23,2
1598380,1649250,"B","3.1_ref",9,"007008",44,88,132,3
1662200,1677130,"A","3.2_ref",10,"007008",26,13,39,3
1700310,1715320,"B","3.3_ref",15,"007008",10,25,35,3
1728200,1738430,"A","3.4_ref",12,"007008",7,9,16,3
1776500,1790810,"B","3.5_ref",1,"007008",5,29,34,3
1805150,1811280,"A","3.6_ref",4,"007008",5,2,7,3
1825440,1836380,"B","3.7_ref",7,"007008",7,10,17,3
1839910,1856590,"A","3.8_ref",16,"007008",16,8,24,3
1868640,1878740,"B","3.9_ref",13,"007008",2,15,17,3
1892050,1900950,"A","3.10_ref",2,"007008",14,2,16,3
1914210,1929670,"B","3.11_ref",11,"007008",5,19,24,3
1939430,1948840,"A","3.12_ref",6,"007008",15,5,20,3
1956250,1970560,"B","3.13_ref",5,"007008",6,23,29,3
1975740,1984540,"A","3.14_ref",8,"007008",9,2,11,3
2002810,2010650,"B","3.15_ref",3,"007008",2,14,16,3
2017930,2040950,"A","3.16_ref",14,"007008",30,20,50,3
2069150,2076140,"B","4.1_ref",10,"007008",4,7,11,4
2088440,2096800,"A","4.2_ref",15,"007008",6,2,8,4
2103890,2112410,"B","4.3_ref",6,"007008",5,12,17,4
2122040,2141470,"A","4.4_ref",1,"007008",24,8,32,4
2155680,2167360,"B","4.5_ref",16,"007008",1,18,19,4
2191610,2199110,"A","4.6_ref",13,"007008",9,1,10,4
2214460,2221900,"B","4.7_ref",12,"007008",6,13,19,4
2234810,2243680,"A","4.8_ref",7,"007008",12,2,14,4
2262360,2271510,"B","4.9_ref",2,"007008",1,11,12,4
2284970,2300830,"A","4.10_ref",9,"007008",16,5,21,4
2314960,2330910,"B","4.11_ref",14,"007008",7,24,31,4
2348940,2365450,"A","4.12_ref",5,"007008",25,17,42,4
2387100,2395060,"B","4.13_ref",8,"007008",3,12,15,4
2418620,2430200,"A","4.14_ref",11,"007008",16,3,19,4
2448390,2453320,"B","4.15_ref",4,"007008",1,5,6,4
2466700,2472740,"A","4.16_ref",3,"007008",5,2,7,4
2478670,2484700,"B","5.1_ref",7,"007008",8,9,17,5
2511410,2518840,"A","5.2_ref",6,"007008",9,2,11,5
2525020,2534720,"B","5.3_ref",11,"007008",3,19,22,5
2568830,2577670,"A","5.4_ref",10,"007008",7,3,10,5
2586280,2598320,"B","5.5_ref",9,"007008",1,16,17,5
2603080,2614070,"A","5.6_ref",4,"007008",11,5,16,5
2626920,2635100,"B","5.7_ref",13,"007008",2,15,17,5
2646710,2655370,"A","5.8_ref",12,"007008",7,1,8,5
2665250,2677920,"B","5.9_ref",1,"007008",6,21,27,5
2693390,2701970,"A","5.10_ref",8,"007008",13,2,15,5
2707760,2715190,"B","5.11_ref",15,"007008",1,10,11,5
2727440,2734830,"A","5.12_ref",14,"007008",14,2,16,5
2741460,2754880,"B","5.13_ref",5,"007008",1,14,15,5
2769450,2785930,"A","5.14_ref",16,"007008",14,3,17,5
2804270,2810080,"B","5.15_ref",3,"007008",1,5,6,5
2815670,2824930,"A","5.16_ref",2,"007008",15,0,15,5
2830510,2836220,"B","6.1_ref",10,"007008",9,10,19,6
2854430,2872250,"A","6.2_ref",11,"007008",19,15,34,6
2885300,2892470,"B","6.3_ref",8,"007008",1,11,12,6
2898790,2906030,"A","6.4_ref",7,"007008",4,2,6,6
2914990,2921220,"B","6.5_ref",4,"007008",2,4,6,6
2940980,2946280,"A","6.6_ref",3,"007008",5,2,7,6
2960590,2968870,"B","6.7_ref",14,"007008",1,12,13,6
2973740,2980630,"A","6.8_ref",13,"007008",7,2,9,6
2986420,2996930,"B","6.9_ref",2,"007008",2,9,11,6
3050210,3063130,"A","6.10_ref",9,"007008",14,2,16,6
3071780,3081350,"B","6.11_ref",6,"007008",1,11,12,6
3122440,3130140,"A","6.12_ref",1,"007008",11,2,13,6
3144400,3156380,"B","6.13_ref",16,"007008",4,15,19,6
3159410,3169350,"A","6.14_ref",5,"007008",10,2,12,6
3172790,3183280,"B","6.15_ref",12,"007008",2,11,13,6
3189730,3195220,"A","6.16_ref",15,"007008",6,0,6,6
3080,82980,"B","1.1_ref",9,"009010",72,108,180,1
121460,201880,"A","1.2_ref",6,"009010",103,140,243,1
257230,299230,"B","1.3_ref",15,"009010",43,80,123,1
328930,379260,"A","1.4_ref",14,"009010",72,64,136,1
403290,441020,"B","1.5_ref",13,"009010",34,80,114,1
492950,588830,"A","1.6_ref",16,"009010",186,100,286,1
603100,629520,"B","1.7_ref",11,"009010",18,48,66,1
663830,726510,"A","1.8_ref",8,"009010",98,86,184,1
763020,801720,"B","1.9_ref",3,"009010",33,78,111,1
818740,848480,"A","1.10_ref",10,"009010",53,67,120,1
856250,891880,"B","1.11_ref",5,"009010",20,60,80,1
904080,932200,"A","1.12_ref",4,"009010",35,46,81,1
943330,979030,"B","1.13_ref",7,"009010",21,67,88,1
985620,1014250,"A","1.14_ref",2,"009010",50,8,58,1
1024670,1041990,"B","1.15_ref",1,"009010",12,42,54,1
1088100,1127910,"A","1.16_ref",12,"009010",72,53,125,1
1148950,1170550,"B","2.1_ref",14,"009010",29,47,76,2
1183120,1220720,"A","2.2_ref",9,"009010",43,45,88,2
1234970,1271390,"B","2.3_ref",16,"009010",46,66,112,2
1278270,1292860,"A","2.4_ref",3,"009010",19,15,34,2
1318040,1327280,"B","2.5_ref",10,"009010",2,20,22,2
1350940,1371260,"A","2.6_ref",11,"009010",32,36,68,2
1378560,1389590,"B","2.7_ref",12,"009010",3,25,28,2
1448610,1467350,"A","2.8_ref",7,"009010",18,5,23,2
1479550,1486640,"B","2.9_ref",6,"009010",2,12,14,2
1519010,1525240,"A","2.10_ref",13,"009010",4,5,9,2
1532360,1549240,"B","2.11_ref",2,"009010",10,19,29,2
1565170,1578710,"A","2.12_ref",15,"009010",19,21,40,2
1587970,1606790,"B","2.13_ref",8,"009010",15,36,51,2
1618780,1632970,"A","2.14_ref",1,"009010",12,20,32,2
1642220,1652130,"B","2.15_ref",4,"009010",7,20,27,2
1681770,1692260,"A","2.16_ref",5,"009010",18,6,24,2
1700940,1717500,"B","3.1_ref",9,"009010",6,34,40,3
1724610,1735590,"A","3.2_ref",10,"009010",18,17,35,3
1761850,1774980,"B","3.3_ref",15,"009010",8,19,27,3
1786440,1798390,"A","3.4_ref",12,"009010",21,8,29,3
1822980,1838570,"B","3.5_ref",1,"009010",5,25,30,3
1856570,1864840,"A","3.6_ref",4,"009010",5,9,14,3
1869780,1880900,"B","3.7_ref",7,"009010",5,12,17,3
1893040,1913400,"A","3.8_ref",16,"009010",33,21,54,3
1924320,1940790,"B","3.9_ref",13,"009010",15,29,44,3
1954830,1970050,"A","3.10_ref",2,"009010",26,13,39,3
1984280,1998400,"B","3.11_ref",11,"009010",6,28,34,3
2010220,2028560,"A","3.12_ref",6,"009010",16,15,31,3
2032670,2042080,"B","3.13_ref",5,"009010",5,14,19,3
2049340,2061910,"A","3.14_ref",8,"009010",16,3,19,3
2076150,2087260,"B","3.15_ref",3,"009010",4,8,12,3
2098270,2109590,"A","3.16_ref",14,"009010",10,8,18,3
2131810,2141640,"B","4.1_ref",10,"009010",5,14,19,4
2159190,2167040,"A","4.2_ref",15,"009010",9,11,20,4
2174200,2181480,"B","4.3_ref",6,"009010",5,8,13,4
2213060,2219850,"A","4.4_ref",1,"009010",6,5,11,4
2228170,2241060,"B","4.5_ref",16,"009010",13,14,27,4
2248290,2254280,"A","4.6_ref",13,"009010",5,4,9,4
2286330,2294660,"B","4.7_ref",12,"009010",4,16,20,4
2312570,2324720,"A","4.8_ref",7,"009010",15,6,21,4
2338230,2346120,"B","4.9_ref",2,"009010",4,19,23,4
2357090,2370030,"A","4.10_ref",9,"009010",22,5,27,4
2378980,2388940,"B","4.11_ref",14,"009010",4,17,21,4
2409290,2417490,"A","4.12_ref",5,"009010",11,5,16,4
2428500,2440040,"B","4.13_ref",8,"009010",3,21,24,4
2446980,2457300,"A","4.14_ref",11,"009010",23,10,33,4
2475980,2490060,"B","4.15_ref",4,"009010",9,18,27,4
2508090,2513920,"A","4.16_ref",3,"009010",8,5,13,4
2517720,2530010,"B","5.1_ref",7,"009010",4,25,29,5
2540280,2546150,"A","5.2_ref",6,"009010",6,4,10,5
2564730,2574600,"B","5.3_ref",11,"009010",3,19,22,5
2590990,2601000,"A","5.4_ref",10,"009010",14,8,22,5
2619110,2629260,"B","5.5_ref",9,"009010",3,17,20,5
2640830,2646830,"A","5.6_ref",4,"009010",6,7,13,5
2658480,2665040,"B","5.7_ref",13,"009010",2,5,7,5
2673420,2680370,"A","5.8_ref",12,"009010",12,3,15,5
2702370,2711050,"B","5.9_ref",1,"009010",1,10,11,5
2730640,2740480,"A","5.10_ref",8,"009010",21,4,25,5
2750510,2758160,"B","5.11_ref",15,"009010",3,10,13,5
2768580,2775090,"A","5.12_ref",14,"009010",10,6,16,5
2790030,2799310,"B","5.13_ref",5,"009010",4,18,22,5
2814920,2826970,"A","5.14_ref",16,"009010",18,10,28,5
2876580,2885290,"B","5.15_ref",3,"009010",4,9,13,5
2897000,2913540,"A","5.16_ref",2,"009010",20,16,36,5
2917900,2924760,"B","6.1_ref",10,"009010",1,7,8,6
2945900,2953780,"A","6.2_ref",11,"009010",10,3,13,6
2974940,2983240,"B","6.3_ref",8,"009010",3,16,19,6
3008230,3016640,"A","6.4_ref",7,"009010",14,5,19,6
3063760,3069150,"B","6.5_ref",4,"009010",3,4,7,6
3079690,3087010,"A","6.6_ref",3,"009010",6,10,16,6
3097280,3106490,"B","6.7_ref",14,"009010",2,14,16,6
3112190,3117490,"A","6.8_ref",13,"009010",4,1,5,6
3131290,3142010,"B","6.9_ref",2,"009010",7,17,24,6
3174320,3183690,"A","6.10_ref",9,"009010",7,6,13,6
3190130,3196720,"B","6.11_ref",6,"009010",5,6,11,6
3213200,3219120,"A","6.12_ref",1,"009010",5,5,10,6
3230350,3238260,"B","6.13_ref",16,"009010",4,9,13,6
3250150,3259330,"A","6.14_ref",5,"009010",20,3,23,6
3263150,3275500,"B","6.15_ref",12,"009010",11,24,35,6
3298520,3304060,"A","6.16_ref",15,"009010",4,5,9,6
2290,52770,"B","1.1_ref",9,"013014",26,64,90,1
121580,137250,"A","1.2_ref",6,"013014",36,3,39,1
161550,182670,"B","1.3_ref",15,"013014",16,34,50,1
276130,291370,"A","1.4_ref",14,"013014",17,9,26,1
311200,327680,"B","1.5_ref",13,"013014",14,22,36,1
353370,389170,"A","1.6_ref",16,"013014",54,19,73,1
401750,423560,"B","1.7_ref",11,"013014",9,36,45,1
458600,496300,"A","1.8_ref",8,"013014",75,12,87,1
519510,539840,"B","1.9_ref",3,"013014",21,29,50,1
563700,609710,"A","1.10_ref",10,"013014",98,10,108,1
637410,691380,"B","1.11_ref",5,"013014",31,96,127,1
700370,729650,"A","1.12_ref",4,"013014",34,18,52,1
766870,780950,"B","1.13_ref",7,"013014",7,27,34,1
803600,824090,"A","1.14_ref",2,"013014",18,15,33,1
851870,872390,"B","1.15_ref",1,"013014",16,28,44,1
928170,955310,"A","1.16_ref",12,"013014",60,9,69,1
974120,985730,"B","2.1_ref",14,"013014",7,14,21,2
996910,1012220,"A","2.2_ref",9,"013014",17,18,35,2
1030220,1066980,"B","2.3_ref",16,"013014",27,60,87,2
1083890,1099340,"A","2.4_ref",3,"013014",28,5,33,2
1118550,1129650,"B","2.5_ref",10,"013014",7,25,32,2
1140860,1149910,"A","2.6_ref",11,"013014",9,6,15,2
1162110,1187870,"B","2.7_ref",12,"013014",30,43,73,2
1234160,1245240,"A","2.8_ref",7,"013014",12,7,19,2
1302360,1310340,"B","2.9_ref",6,"013014",3,14,17,2
1354230,1377780,"A","2.10_ref",13,"013014",34,9,43,2
1394080,1405530,"B","2.11_ref",2,"013014",5,10,15,2
1428540,1458980,"A","2.12_ref",15,"013014",47,15,62,2
1491820,1503550,"B","2.13_ref",8,"013014",10,22,32,2
1513770,1524980,"A","2.14_ref",1,"013014",19,7,26,2
1555370,1602720,"B","2.15_ref",4,"013014",47,72,119,2
1632280,1648160,"A","2.16_ref",5,"013014",21,13,34,2
1673580,1693090,"B","3.1_ref",9,"013014",13,37,50,3
1709030,1731250,"A","3.2_ref",10,"013014",28,24,52,3
1761150,1774950,"B","3.3_ref",15,"013014",12,10,22,3
1804280,1826390,"A","3.4_ref",12,"013014",33,14,47,3
1884500,1892620,"B","3.5_ref",1,"013014",9,9,18,3
1921360,1935720,"A","3.6_ref",4,"013014",27,5,32,3
1976780,1984770,"B","3.7_ref",7,"013014",6,6,12,3
2001660,2035530,"A","3.8_ref",16,"013014",55,20,75,3
2048610,2056390,"B","3.9_ref",13,"013014",3,13,16,3
2094410,2107740,"A","3.10_ref",2,"013014",13,21,34,3
2166600,2177690,"B","3.11_ref",11,"013014",17,19,36,3
2200790,2210490,"A","3.12_ref",6,"013014",12,8,20,3
2243480,2264120,"B","3.13_ref",5,"013014",18,42,60,3
2278510,2300830,"A","3.14_ref",8,"013014",49,10,59,3
2311870,2320870,"B","3.15_ref",3,"013014",5,15,20,3
2334650,2341020,"A","3.16_ref",14,"013014",7,2,9,3
2350800,2361370,"B","4.1_ref",10,"013014",4,17,21,4
2444290,2452100,"A","4.2_ref",15,"013014",14,6,20,4
2532460,2540170,"B","4.3_ref",6,"013014",5,14,19,4
2573900,2580960,"A","4.4_ref",1,"013014",12,3,15,4
2607990,2624900,"B","4.5_ref",16,"013014",8,19,27,4
2655250,2665840,"A","4.6_ref",13,"013014",15,6,21,4
2692570,2712940,"B","4.7_ref",12,"013014",9,30,39,4
2734310,2743970,"A","4.8_ref",7,"013014",10,3,13,4
2776940,2793380,"B","4.9_ref",2,"013014",10,12,22,4
2815490,2825400,"A","4.10_ref",9,"013014",9,3,12,4
2872050,2881000,"B","4.11_ref",14,"013014",8,8,16,4
2901730,2912130,"A","4.12_ref",5,"013014",7,11,18,4
2931390,2957090,"B","4.13_ref",8,"013014",28,37,65,4
2976120,3055750,"A","4.14_ref",11,"013014",108,83,191,4
3071000,3084000,"B","4.15_ref",4,"013014",30,9,39,4
3100870,3166130,"A","4.16_ref",3,"013014",151,26,177,4
3194330,3205560,"B","5.1_ref",7,"013014",13,6,19,5
3234200,3246100,"A","5.2_ref",6,"013014",15,4,19,5
3262610,3269680,"B","5.3_ref",11,"013014",3,12,15,5
3312040,3337090,"A","5.4_ref",10,"013014",36,33,69,5
3373380,3388470,"B","5.5_ref",9,"013014",6,15,21,5
3428160,3448030,"A","5.6_ref",4,"013014",28,14,42,5
3461550,3468690,"B","5.7_ref",13,"013014",7,10,17,5
3480350,3492040,"A","5.8_ref",12,"013014",18,4,22,5
3504750,3513350,"B","5.9_ref",1,"013014",6,6,12,5
3559330,3575980,"A","5.10_ref",8,"013014",27,5,32,5
3594440,3605480,"B","5.11_ref",15,"013014",11,11,22,5
3631590,3639570,"A","5.12_ref",14,"013014",12,3,15,5
3653770,3672510,"B","5.13_ref",5,"013014",7,22,29,5
3688480,3698840,"A","5.14_ref",16,"013014",16,3,19,5
3722650,3731890,"B","5.15_ref",3,"013014",6,7,13,5
3757340,3781020,"A","5.16_ref",2,"013014",22,49,71,5
3796620,3813470,"B","6.1_ref",10,"013014",19,28,47,6
3829940,3838200,"A","6.2_ref",11,"013014",10,5,15,6
3849260,3858220,"B","6.3_ref",8,"013014",11,16,27,6
3872600,3879850,"A","6.4_ref",7,"013014",8,7,15,6
3902360,3912080,"B","6.5_ref",4,"013014",7,7,14,6
3925070,3933860,"A","6.6_ref",3,"013014",9,4,13,6
3951460,3961450,"B","6.7_ref",14,"013014",9,8,17,6
3971440,4006830,"A","6.8_ref",13,"013014",64,26,90,6
4016570,4029240,"B","6.9_ref",2,"013014",12,10,22,6
4045980,4057980,"A","6.10_ref",9,"013014",23,3,26,6
4070620,4092050,"B","6.11_ref",6,"013014",16,41,57,6
4112570,4120030,"A","6.12_ref",1,"013014",6,5,11,6
4135290,4143550,"B","6.13_ref",16,"013014",4,14,18,6
4152060,4161260,"A","6.14_ref",5,"013014",5,5,10,6
4172480,4182430,"B","6.15_ref",12,"013014",5,24,29,6
4235160,4244150,"A","6.16_ref",15,"013014",9,4,13,6
3280,38410,"B","1.1_ref",9,"015016",39,59,98,1
73960,89350,"A","1.2_ref",6,"015016",25,9,34,1
120300,134280,"B","1.3_ref",15,"015016",9,19,28,1
145780,168710,"A","1.4_ref",14,"015016",51,19,70,1
181800,199000,"B","1.5_ref",13,"015016",13,43,56,1
236530,279040,"A","1.6_ref",16,"015016",82,27,109,1
296350,320960,"B","1.7_ref",11,"015016",13,46,59,1
339400,373230,"A","1.8_ref",8,"015016",60,45,105,1
400660,412350,"B","1.9_ref",3,"015016",18,14,32,1
420910,445840,"A","1.10_ref",10,"015016",42,18,60,1
462510,488310,"B","1.11_ref",5,"015016",16,62,78,1
498860,523820,"A","1.12_ref",4,"015016",37,21,58,1
542390,562520,"B","1.13_ref",7,"015016",14,46,60,1
580910,596490,"A","1.14_ref",2,"015016",31,5,36,1
612700,632540,"B","1.15_ref",1,"015016",11,36,47,1
662750,677240,"A","1.16_ref",12,"015016",22,13,35,1
700100,727210,"B","2.1_ref",14,"015016",16,42,58,2
734000,745350,"A","2.2_ref",9,"015016",24,5,29,2
762950,779250,"B","2.3_ref",16,"015016",11,31,42,2
795670,804150,"A","2.4_ref",3,"015016",13,3,16,2
825660,848400,"B","2.5_ref",10,"015016",17,49,66,2
867650,884090,"A","2.6_ref",11,"015016",32,6,38,2
893120,901780,"B","2.7_ref",12,"015016",5,10,15,2
925230,938630,"A","2.8_ref",7,"015016",22,5,27,2
954670,972950,"B","2.9_ref",6,"015016",17,22,39,2
1035180,1048090,"A","2.10_ref",13,"015016",19,4,23,2
1052200,1068850,"B","2.11_ref",2,"015016",10,31,41,2
1079660,1099570,"A","2.12_ref",15,"015016",34,8,42,2
1110260,1118260,"B","2.13_ref",8,"015016",12,7,19,2
1126870,1132800,"A","2.14_ref",1,"015016",9,2,11,2
1152090,1169350,"B","2.15_ref",4,"015016",15,32,47,2
1190480,1205690,"A","2.16_ref",5,"015016",15,21,36,2
1214960,1229090,"B","3.1_ref",9,"015016",11,19,30,3
1235020,1245220,"A","3.2_ref",10,"015016",22,5,27,3
1275230,1288350,"B","3.3_ref",15,"015016",8,19,27,3
1295910,1303070,"A","3.4_ref",12,"015016",8,4,12,3
1320590,1327960,"B","3.5_ref",1,"015016",8,10,18,3
1345330,1358310,"A","3.6_ref",4,"015016",19,8,27,3
1366220,1383940,"B","3.7_ref",7,"015016",17,19,36,3
1389840,1417360,"A","3.8_ref",16,"015016",41,19,60,3
1442490,1450330,"B","3.9_ref",13,"015016",4,18,22,3
1466440,1475580,"A","3.10_ref",2,"015016",13,10,23,3
1496820,1512860,"B","3.11_ref",11,"015016",7,32,39,3
1526410,1535750,"A","3.12_ref",6,"015016",17,8,25,3
1545340,1561980,"B","3.13_ref",5,"015016",4,7,11,3
1568830,1581550,"A","3.14_ref",8,"015016",8,6,14,3
1594330,1607780,"B","3.15_ref",3,"015016",16,24,40,3
1620140,1629280,"A","3.16_ref",14,"015016",17,2,19,3
1656810,1681780,"B","4.1_ref",10,"015016",19,23,42,4
1764670,1787680,"A","4.2_ref",15,"015016",46,17,63,4
1797300,1808100,"B","4.3_ref",6,"015016",12,9,21,4
1868340,1874400,"A","4.4_ref",1,"015016",8,3,11,4
1885540,1902110,"B","4.5_ref",16,"015016",12,15,27,4
1910210,1922710,"A","4.6_ref",13,"015016",25,2,27,4
1945910,1953080,"B","4.7_ref",12,"015016",4,5,9,4
1966850,1975620,"A","4.8_ref",7,"015016",12,3,15,4
1992550,1999550,"B","4.9_ref",2,"015016",6,8,14,4
2018750,2027110,"A","4.10_ref",9,"015016",15,3,18,4
2058360,2067420,"B","4.11_ref",14,"015016",8,10,18,4
2085080,2091430,"A","4.12_ref",5,"015016",4,3,7,4
2123300,2129040,"B","4.13_ref",8,"015016",4,6,10,4
2156370,2167200,"A","4.14_ref",11,"015016",20,6,26,4
2182700,2189690,"B","4.15_ref",4,"015016",3,12,15,4
2220610,2227120,"A","4.16_ref",3,"015016",8,6,14,4
2231760,2236500,"B","5.1_ref",7,"015016",2,3,5,5
2256550,2265670,"A","5.2_ref",6,"015016",9,8,17,5
2282410,2301460,"B","5.3_ref",11,"015016",11,25,36,5
2324750,2333060,"A","5.4_ref",10,"015016",13,3,16,5
2354880,2364180,"B","5.5_ref",9,"015016",11,7,18,5
2377750,2390910,"A","5.6_ref",4,"015016",25,6,31,5
2430840,2441590,"B","5.7_ref",13,"015016",7,18,25,5
2448630,2455610,"A","5.8_ref",12,"015016",6,2,8,5
2469200,2475260,"B","5.9_ref",1,"015016",5,5,10,5
2499170,2505810,"A","5.10_ref",8,"015016",3,3,6,5
2514500,2529430,"B","5.11_ref",15,"015016",24,25,49,5
2545780,2551750,"A","5.12_ref",14,"015016",17,3,20,5
2569480,2578870,"B","5.13_ref",5,"015016",11,3,14,5
2601900,2615740,"A","5.14_ref",16,"015016",22,20,42,5
2631970,2636710,"B","5.15_ref",3,"015016",6,8,14,5
2644440,2654760,"A","5.16_ref",2,"015016",19,5,24,5
2659570,2671040,"B","6.1_ref",10,"015016",13,15,28,6
2699360,2708800,"A","6.2_ref",11,"015016",21,4,25,6
2734840,2740040,"B","6.3_ref",8,"015016",7,5,12,6
2755730,2760780,"A","6.4_ref",7,"015016",8,2,10,6
2778640,2784750,"B","6.5_ref",4,"015016",3,14,17,6
2802210,2806830,"A","6.6_ref",3,"015016",6,3,9,6
2820160,2827600,"B","6.7_ref",14,"015016",3,10,13,6
2835660,2844000,"A","6.8_ref",13,"015016",15,3,18,6
2855630,2865290,"B","6.9_ref",2,"015016",8,10,18,6
2884830,2891460,"A","6.10_ref",9,"015016",14,2,16,6
2907910,2919560,"B","6.11_ref",6,"015016",17,8,25,6
2926010,2933210,"A","6.12_ref",1,"015016",8,2,10,6
2946220,2960760,"B","6.13_ref",16,"015016",13,17,30,6
2979280,2985620,"A","6.14_ref",5,"015016",7,5,12,6
2993420,2998660,"B","6.15_ref",12,"015016",6,3,9,6
3009560,3018660,"A","6.16_ref",15,"015016",22,5,27,6
5680,162970,"B","1.1_ref",9,"017018",32,132,164,1
200240,229170,"A","1.2_ref",6,"017018",28,46,74,1
281670,307900,"B","1.3_ref",15,"017018",19,67,86,1
331870,359940,"A","1.4_ref",14,"017018",28,51,79,1
381100,399320,"B","1.5_ref",13,"017018",17,40,57,1
426510,462890,"A","1.6_ref",16,"017018",55,40,95,1
483830,517150,"B","1.7_ref",11,"017018",26,72,98,1
551320,581020,"A","1.8_ref",8,"017018",37,37,74,1
601950,617150,"B","1.9_ref",3,"017018",10,34,44,1
631790,648760,"A","1.10_ref",10,"017018",37,10,47,1
681870,709480,"B","1.11_ref",5,"017018",18,67,85,1
737620,757810,"A","1.12_ref",4,"017018",45,15,60,1
775380,794020,"B","1.13_ref",7,"017018",15,40,55,1
809120,836660,"A","1.14_ref",2,"017018",56,26,82,1
848850,865170,"B","1.15_ref",1,"017018",12,40,52,1
881360,913980,"A","1.16_ref",12,"017018",64,41,105,1
924600,945180,"B","2.1_ref",14,"017018",11,53,64,2
954250,974090,"A","2.2_ref",9,"017018",37,6,43,2
989430,1018020,"B","2.3_ref",16,"017018",23,62,85,2
1037390,1048330,"A","2.4_ref",3,"017018",16,4,20,2
1070650,1089580,"B","2.5_ref",10,"017018",14,42,56,2
1128940,1149010,"A","2.6_ref",11,"017018",26,23,49,2
1166820,1184610,"B","2.7_ref",12,"017018",7,46,53,2
1204910,1215430,"A","2.8_ref",7,"017018",17,10,27,2
1234500,1251440,"B","2.9_ref",6,"017018",11,38,49,2
1285470,1294080,"A","2.10_ref",13,"017018",13,12,25,2
1306440,1320660,"B","2.11_ref",2,"017018",8,37,45,2
1338500,1353750,"A","2.12_ref",15,"017018",20,15,35,2
1373030,1390050,"B","2.13_ref",8,"017018",7,46,53,2
1406710,1421730,"A","2.14_ref",1,"017018",35,8,43,2
1433630,1454600,"B","2.15_ref",4,"017018",12,43,55,2
1464670,1481040,"A","2.16_ref",5,"017018",19,11,30,2
1491940,1508040,"B","3.1_ref",9,"017018",7,40,47,3
1516820,1529020,"A","3.2_ref",10,"017018",25,8,33,3
1542820,1555490,"B","3.3_ref",15,"017018",9,26,35,3
1563370,1570910,"A","3.4_ref",12,"017018",12,6,18,3
1588640,1601370,"B","3.5_ref",1,"017018",9,32,41,3
1613940,1627200,"A","3.6_ref",4,"017018",15,15,30,3
1638550,1653370,"B","3.7_ref",7,"017018",12,18,30,3
1667800,1679180,"A","3.8_ref",16,"017018",25,7,32,3
1694600,1701370,"B","3.9_ref",13,"017018",4,16,20,3
1731720,1742600,"A","3.10_ref",2,"017018",20,5,25,3
1766430,1775040,"B","3.11_ref",11,"017018",9,21,30,3
1782320,1793530,"A","3.12_ref",6,"017018",20,7,27,3
1821530,1832710,"B","3.13_ref",5,"017018",12,17,29,3
1843480,1859980,"A","3.14_ref",8,"017018",21,10,31,3
1878500,1888980,"B","3.15_ref",3,"017018",6,14,20,3
1900670,1909680,"A","3.16_ref",14,"017018",8,9,17,3
1924820,1940850,"B","4.1_ref",10,"017018",7,22,29,4
1957280,1968920,"A","4.2_ref",15,"017018",16,9,25,4
2007140,2016280,"B","4.3_ref",6,"017018",6,19,25,4
2049110,2062060,"A","4.4_ref",1,"017018",13,5,18,4
2078760,2089200,"B","4.5_ref",16,"017018",10,26,36,4
2101380,2107770,"A","4.6_ref",13,"017018",9,5,14,4
2125950,2151550,"B","4.7_ref",12,"017018",29,40,69,4
2170270,2184700,"A","4.8_ref",7,"017018",10,6,16,4
2202630,2212930,"B","4.9_ref",2,"017018",6,23,29,4
2222550,2234670,"A","4.10_ref",9,"017018",24,9,33,4
2250750,2256670,"B","4.11_ref",14,"017018",6,10,16,4
2272110,2285100,"A","4.12_ref",5,"017018",27,21,48,4
2312650,2321120,"B","4.13_ref",8,"017018",7,23,30,4
2328950,2341650,"A","4.14_ref",11,"017018",9,9,18,4
2355000,2366500,"B","4.15_ref",4,"017018",7,24,31,4
2378310,2386260,"A","4.16_ref",3,"017018",14,7,21,4
2390890,2401530,"B","5.1_ref",7,"017018",8,18,26,5
2422690,2431180,"A","5.2_ref",6,"017018",12,5,17,5
2449580,2455600,"B","5.3_ref",11,"017018",5,7,12,5
2479260,2487580,"A","5.4_ref",10,"017018",11,6,17,5
2499760,2512190,"B","5.5_ref",9,"017018",9,28,37,5
2520220,2530720,"A","5.6_ref",4,"017018",22,7,29,5
2545880,2551220,"B","5.7_ref",13,"017018",6,8,14,5
2581890,2589960,"A","5.8_ref",12,"017018",12,5,17,5
2612110,2622800,"B","5.9_ref",1,"017018",5,26,31,5
2647260,2658700,"A","5.10_ref",8,"017018",22,4,26,5
2674300,2683030,"B","5.11_ref",15,"017018",5,17,22,5
2701590,2708010,"A","5.12_ref",14,"017018",7,5,12,5
2760410,2771070,"B","5.13_ref",5,"017018",8,19,27,5
2783530,2794400,"A","5.14_ref",16,"017018",14,4,18,5
2810290,2817220,"B","5.15_ref",3,"017018",4,15,19,5
2838940,2854160,"A","5.16_ref",2,"017018",16,9,25,5
2859340,2870700,"B","6.1_ref",10,"017018",6,23,29,6
2907900,2916360,"A","6.2_ref",11,"017018",7,3,10,6
2937570,2946830,"B","6.3_ref",8,"017018",11,15,26,6
2960280,2968420,"A","6.4_ref",7,"017018",10,2,12,6
2986760,2995410,"B","6.5_ref",4,"017018",5,20,25,6
3013060,3020060,"A","6.6_ref",3,"017018",8,6,14,6
3032010,3036610,"B","6.7_ref",14,"017018",1,5,6,6
3060660,3066050,"A","6.8_ref",13,"017018",5,5,10,6
3076720,3089320,"B","6.9_ref",2,"017018",9,14,23,6
3105940,3116020,"A","6.10_ref",9,"017018",16,6,22,6
3134330,3142830,"B","6.11_ref",6,"017018",6,13,19,6
3155380,3170040,"A","6.12_ref",1,"017018",17,2,19,6
3184690,3193460,"B","6.13_ref",16,"017018",5,13,18,6
3198360,3206010,"A","6.14_ref",5,"017018",7,8,15,6
3213570,3231740,"B","6.15_ref",12,"017018",19,32,51,6
3247930,3255730,"A","6.16_ref",15,"017018",18,4,22,6
3950,61290,"B","1.1_ref",9,"019020",87,58,145,1
125330,169040,"A","1.2_ref",6,"019020",108,26,134,1
315230,344930,"B","1.3_ref",15,"019020",35,54,89,1
378440,416310,"A","1.4_ref",14,"019020",79,17,96,1
460870,477970,"B","1.5_ref",13,"019020",16,30,46,1
531220,593160,"A","1.6_ref",16,"019020",143,42,185,1
629440,649390,"B","1.7_ref",11,"019020",10,45,55,1
666560,726290,"A","1.8_ref",8,"019020",142,43,185,1
765060,786800,"B","1.9_ref",3,"019020",14,35,49,1
839700,875010,"A","1.10_ref",10,"019020",75,28,103,1
934460,963440,"B","1.11_ref",5,"019020",15,45,60,1
980730,1028430,"A","1.12_ref",4,"019020",109,38,147,1
1108700,1126400,"B","1.13_ref",7,"019020",11,31,42,1
1149140,1167850,"A","1.14_ref",2,"019020",36,10,46,1
1182570,1200420,"B","1.15_ref",1,"019020",11,25,36,1
1222070,1302710,"A","1.16_ref",12,"019020",186,40,226,1
1325470,1340770,"B","2.1_ref",14,"019020",7,32,39,2
1353050,1372600,"A","2.2_ref",9,"019020",32,6,38,2
1413120,1429400,"B","2.3_ref",16,"019020",11,33,44,2
1465780,1479360,"A","2.4_ref",3,"019020",23,7,30,2
1493220,1504950,"B","2.5_ref",10,"019020",7,14,21,2
1521480,1540560,"A","2.6_ref",11,"019020",39,7,46,2
1583100,1594900,"B","2.7_ref",12,"019020",7,20,27,2
1618470,1643480,"A","2.8_ref",7,"019020",45,12,57,2
1701420,1710520,"B","2.9_ref",6,"019020",6,15,21,2
1808210,1823400,"A","2.10_ref",13,"019020",35,11,46,2
1832560,1848610,"B","2.11_ref",2,"019020",29,21,50,2
1887680,1905090,"A","2.12_ref",15,"019020",32,9,41,2
1921560,1959230,"B","2.13_ref",8,"019020",56,49,105,2
1978130,1989150,"A","2.14_ref",1,"019020",25,5,30,2
2016360,2026100,"B","2.15_ref",4,"019020",12,9,21,2
2069130,2084990,"A","2.16_ref",5,"019020",29,6,35,2
2113530,2124670,"B","3.1_ref",9,"019020",7,23,30,3
2142140,2154120,"A","3.2_ref",10,"019020",22,6,28,3
2187080,2201290,"B","3.3_ref",15,"019020",7,23,30,3
2212970,2226180,"A","3.4_ref",12,"019020",25,3,28,3
2246390,2254490,"B","3.5_ref",1,"019020",5,16,21,3
2276240,2284600,"A","3.6_ref",4,"019020",11,5,16,3
2294980,2304140,"B","3.7_ref",7,"019020",9,16,25,3
2321850,2336510,"A","3.8_ref",16,"019020",23,7,30,3
2374940,2388610,"B","3.9_ref",13,"019020",11,22,33,3
2432230,2439160,"A","3.10_ref",2,"019020",11,4,15,3
2474590,2485620,"B","3.11_ref",11,"019020",6,24,30,3
2515130,2525780,"A","3.12_ref",6,"019020",19,9,28,3
2549090,2564510,"B","3.13_ref",5,"019020",12,14,26,3
2573450,2582600,"A","3.14_ref",8,"019020",11,7,18,3
2630000,2639960,"B","3.15_ref",3,"019020",7,16,23,3
2657170,2666800,"A","3.16_ref",14,"019020",20,4,24,3
2700750,2711150,"B","4.1_ref",10,"019020",5,11,16,4
2741560,2756120,"A","4.2_ref",15,"019020",21,4,25,4
2783200,2789950,"B","4.3_ref",6,"019020",6,7,13,4
2820690,2828660,"A","4.4_ref",1,"019020",12,4,16,4
2846950,2860080,"B","4.5_ref",16,"019020",3,20,23,4
2876080,2887520,"A","4.6_ref",13,"019020",24,5,29,4
2963690,2975100,"B","4.7_ref",12,"019020",5,16,21,4
2988400,3002080,"A","4.8_ref",7,"019020",24,5,29,4
3023380,3034240,"B","4.9_ref",2,"019020",4,13,17,4
3046930,3056260,"A","4.10_ref",9,"019020",18,4,22,4
3074750,3083410,"B","4.11_ref",14,"019020",5,17,22,4
3094480,3104470,"A","4.12_ref",5,"019020",15,3,18,4
3136120,3144280,"B","4.13_ref",8,"019020",8,10,18,4
3163580,3181070,"A","4.14_ref",11,"019020",25,12,37,4
3202920,3208390,"B","4.15_ref",4,"019020",3,3,6,4
3235190,3245050,"A","4.16_ref",3,"019020",24,4,28,4
3298230,3304100,"B","5.1_ref",7,"019020",6,10,16,5
3346760,3354780,"A","5.2_ref",6,"019020",12,4,16,5
3372970,3380580,"B","5.3_ref",11,"019020",4,11,15,5
3395680,3403020,"A","5.4_ref",10,"019020",14,3,17,5
3415740,3423950,"B","5.5_ref",9,"019020",6,14,20,5
3442440,3449410,"A","5.6_ref",4,"019020",3,5,8,5
3463640,3472150,"B","5.7_ref",13,"019020",4,16,20,5
3484360,3493700,"A","5.8_ref",12,"019020",19,3,22,5
3519770,3531910,"B","5.9_ref",1,"019020",6,14,20,5
3561450,3571280,"A","5.10_ref",8,"019020",8,5,13,5
3585900,3595500,"B","5.11_ref",15,"019020",7,14,21,5
3604920,3620240,"A","5.12_ref",14,"019020",18,4,22,5
3643790,3655690,"B","5.13_ref",5,"019020",5,12,17,5
3692770,3709290,"A","5.14_ref",16,"019020",19,8,27,5
3720180,3738020,"B","5.15_ref",3,"019020",20,14,34,5
3747290,3755200,"A","5.16_ref",2,"019020",15,4,19,5
3766500,3774450,"B","6.1_ref",10,"019020",9,8,17,6
3783620,3794370,"A","6.2_ref",11,"019020",22,4,26,6
3810300,3815140,"B","6.3_ref",8,"019020",5,2,7,6
3824640,3836400,"A","6.4_ref",7,"019020",22,5,27,6
3857460,3861680,"B","6.5_ref",4,"019020",4,3,7,6
3871970,3882660,"A","6.6_ref",3,"019020",15,3,18,6
3901540,3910700,"B","6.7_ref",14,"019020",4,15,19,6
3917060,3928790,"A","6.8_ref",13,"019020",15,5,20,6
3947270,3954300,"B","6.9_ref",2,"019020",4,15,19,6
3974010,3981840,"A","6.10_ref",9,"019020",15,3,18,6
3993050,3998850,"B","6.11_ref",6,"019020",5,9,14,6
4014930,4025030,"A","6.12_ref",1,"019020",19,4,23,6
4037770,4048990,"B","6.13_ref",16,"019020",7,17,24,6
4075320,4084840,"A","6.14_ref",5,"019020",17,3,20,6
4095700,4102450,"B","6.15_ref",12,"019020",4,16,20,6
4117950,4131270,"A","6.16_ref",15,"019020",30,7,37,6
3090,73910,"B","1.1_ref",9,"021022",53,159,212,1
114410,132170,"A","1.2_ref",6,"021022",36,16,52,1
168680,188340,"B","1.3_ref",15,"021022",14,45,59,1
203540,231990,"A","1.4_ref",14,"021022",41,33,74,1
248960,261680,"B","1.5_ref",13,"021022",7,27,34,1
308090,335930,"A","1.6_ref",16,"021022",50,30,80,1
352630,375060,"B","1.7_ref",11,"021022",22,51,73,1
387280,409240,"A","1.8_ref",8,"021022",38,21,59,1
444740,468000,"B","1.9_ref",3,"021022",21,55,76,1
476750,514260,"A","1.10_ref",10,"021022",60,42,102,1
521260,551400,"B","1.11_ref",5,"021022",12,82,94,1
565040,601480,"A","1.12_ref",4,"021022",60,50,110,1
620450,642540,"B","1.13_ref",7,"021022",8,57,65,1
653670,671840,"A","1.14_ref",2,"021022",39,13,52,1
678390,694800,"B","1.15_ref",1,"021022",13,43,56,1
704710,722470,"A","1.16_ref",12,"021022",30,20,50,1
735330,751710,"B","2.1_ref",14,"021022",16,39,55,2
757080,804200,"A","2.2_ref",9,"021022",105,44,149,2
822120,839260,"B","2.3_ref",16,"021022",8,43,51,2
844560,855130,"A","2.4_ref",3,"021022",23,15,38,2
885780,905950,"B","2.5_ref",10,"021022",20,38,58,2
922200,939490,"A","2.6_ref",11,"021022",33,16,49,2
948330,967250,"B","2.7_ref",12,"021022",14,40,54,2
978510,994140,"A","2.8_ref",7,"021022",37,16,53,2
1009700,1020500,"B","2.9_ref",6,"021022",8,24,32,2
1034350,1047940,"A","2.10_ref",13,"021022",25,26,51,2
1064390,1087020,"B","2.11_ref",2,"021022",15,51,66,2
1097630,1110930,"A","2.12_ref",15,"021022",31,8,39,2
1116240,1139010,"B","2.13_ref",8,"021022",12,58,70,2
1149090,1166100,"A","2.14_ref",1,"021022",45,19,64,2
1174080,1192550,"B","2.15_ref",4,"021022",12,53,65,2
1244020,1265400,"A","2.16_ref",5,"021022",53,20,73,2
1273660,1295580,"B","3.1_ref",9,"021022",16,59,75,3
1303640,1322980,"A","3.2_ref",10,"021022",30,20,50,3
1402040,1415490,"B","3.3_ref",15,"021022",7,31,38,3
1420620,1435190,"A","3.4_ref",12,"021022",27,15,42,3
1468490,1481550,"B","3.5_ref",1,"021022",16,27,43,3
1510210,1534890,"A","3.6_ref",4,"021022",48,28,76,3
1539600,1555530,"B","3.7_ref",7,"021022",11,39,50,3
1562180,1578480,"A","3.8_ref",16,"021022",42,4,46,3
1593670,1604420,"B","3.9_ref",13,"021022",14,28,42,3
1654720,1663320,"A","3.10_ref",2,"021022",25,9,34,3
1674420,1689760,"B","3.11_ref",11,"021022",17,37,54,3
1697850,1703510,"A","3.12_ref",6,"021022",5,6,11,3
1711670,1727810,"B","3.13_ref",5,"021022",6,40,46,3
1734600,1758030,"A","3.14_ref",8,"021022",53,15,68,3
1789880,1798040,"B","3.15_ref",3,"021022",10,13,23,3
1805880,1815620,"A","3.16_ref",14,"021022",23,10,33,3
1834400,1845560,"B","4.1_ref",10,"021022",8,24,32,4
1856830,1865960,"A","4.2_ref",15,"021022",14,15,29,4
1872320,1885130,"B","4.3_ref",6,"021022",24,26,50,4
1906430,1914100,"A","4.4_ref",1,"021022",18,7,25,4
1921130,1935310,"B","4.5_ref",16,"021022",8,40,48,4
1979120,1991750,"A","4.6_ref",13,"021022",35,11,46,4
2010310,2044060,"B","4.7_ref",12,"021022",28,55,83,4
2054720,2067660,"A","4.8_ref",7,"021022",35,11,46,4
2079860,2094850,"B","4.9_ref",2,"021022",6,37,43,4
2103760,2119980,"A","4.10_ref",9,"021022",28,26,54,4
2137150,2146620,"B","4.11_ref",14,"021022",7,18,25,4
2160360,2173440,"A","4.12_ref",5,"021022",29,7,36,4
2192900,2205320,"B","4.13_ref",8,"021022",4,32,36,4
2212820,2225800,"A","4.14_ref",11,"021022",32,8,40,4
2243730,2258110,"B","4.15_ref",4,"021022",9,37,46,4
2265370,2270600,"A","4.16_ref",3,"021022",4,6,10,4
2276960,2295280,"B","5.1_ref",7,"021022",10,36,46,5
2308990,2315030,"A","5.2_ref",6,"021022",11,7,18,5
2328550,2339890,"B","5.3_ref",11,"021022",7,23,30,5
2369550,2380280,"A","5.4_ref",10,"021022",24,6,30,5
2406810,2427160,"B","5.5_ref",9,"021022",8,53,61,5
2435490,2446350,"A","5.6_ref",4,"021022",27,5,32,5
2455060,2474070,"B","5.7_ref",13,"021022",15,39,54,5
2479540,2488460,"A","5.8_ref",12,"021022",14,6,20,5
2497060,2508090,"B","5.9_ref",1,"021022",8,19,27,5
2520700,2531580,"A","5.10_ref",8,"021022",25,5,30,5
2544160,2554670,"B","5.11_ref",15,"021022",7,15,22,5
2560520,2567240,"A","5.12_ref",14,"021022",12,5,17,5
2572470,2586950,"B","5.13_ref",5,"021022",5,34,39,5
2594380,2607140,"A","5.14_ref",16,"021022",28,3,31,5
2618140,2624440,"B","5.15_ref",3,"021022",5,7,12,5
2629250,2638210,"A","5.16_ref",2,"021022",15,5,20,5
2641530,2669120,"B","6.1_ref",10,"021022",21,44,65,6
2680910,2692000,"A","6.2_ref",11,"021022",29,8,37,6
2741100,2757950,"B","6.3_ref",8,"021022",17,32,49,6
2764060,2776960,"A","6.4_ref",7,"021022",30,9,39,6
2786750,2799990,"B","6.5_ref",4,"021022",10,31,41,6
2841510,2847880,"A","6.6_ref",3,"021022",5,11,16,6
2861000,2866210,"B","6.7_ref",14,"021022",5,6,11,6
2875520,2886720,"A","6.8_ref",13,"021022",32,3,35,6
2897220,2909100,"B","6.9_ref",2,"021022",5,25,30,6
2916710,2933490,"A","6.10_ref",9,"021022",37,18,55,6
2938860,2944450,"B","6.11_ref",6,"021022",5,6,11,6
2953200,2964200,"A","6.12_ref",1,"021022",21,7,28,6
2973960,2986110,"B","6.13_ref",16,"021022",6,30,36,6
2990030,3002520,"A","6.14_ref",5,"021022",34,2,36,6
3005820,3015940,"B","6.15_ref",12,"021022",5,21,26,6
3026860,3033270,"A","6.16_ref",15,"021022",4,8,12,6
1730,51060,"B","1.1_ref",9,"025026",32,73,105,1
74450,107980,"A","1.2_ref",6,"025026",70,17,87,1
132820,160180,"B","1.3_ref",15,"025026",13,57,70,1
184770,222420,"A","1.4_ref",14,"025026",67,24,91,1
257440,286400,"B","1.5_ref",13,"025026",33,48,81,1
321910,378130,"A","1.6_ref",16,"025026",145,20,165,1
397920,416400,"B","1.7_ref",11,"025026",6,45,51,1
438750,477380,"A","1.8_ref",8,"025026",68,29,97,1
492870,504390,"B","1.9_ref",3,"025026",2,31,33,1
534680,577710,"A","1.10_ref",10,"025026",97,50,147,1
601080,640450,"B","1.11_ref",5,"025026",32,64,96,1
649930,771350,"A","1.12_ref",4,"025026",211,157,368,1
791210,805870,"B","1.13_ref",7,"025026",15,41,56,1
818920,832350,"A","1.14_ref",2,"025026",28,8,36,1
843380,859590,"B","1.15_ref",1,"025026",4,36,40,1
869630,886440,"A","1.16_ref",12,"025026",41,9,50,1
897320,910480,"B","2.1_ref",14,"025026",13,22,35,2
915310,929460,"A","2.2_ref",9,"025026",37,5,42,2
941050,998200,"B","2.3_ref",16,"025026",50,65,115,2
1005220,1015130,"A","2.4_ref",3,"025026",24,4,28,2
1024560,1035030,"B","2.5_ref",10,"025026",20,16,36,2
1043420,1058770,"A","2.6_ref",11,"025026",34,4,38,2
1066820,1075440,"B","2.7_ref",12,"025026",4,18,22,2
1082520,1104660,"A","2.8_ref",7,"025026",42,12,54,2
1141190,1152200,"B","2.9_ref",6,"025026",11,21,32,2
1187190,1200340,"A","2.10_ref",13,"025026",30,5,35,2
1204930,1210690,"B","2.11_ref",2,"025026",5,8,13,2
1218640,1232060,"A","2.12_ref",15,"025026",32,7,39,2
1239270,1260040,"B","2.13_ref",8,"025026",29,33,62,2
1265110,1275330,"A","2.14_ref",1,"025026",24,3,27,2
1286260,1297580,"B","2.15_ref",4,"025026",11,20,31,2
1306670,1336120,"A","2.16_ref",5,"025026",46,36,82,2
1344370,1350610,"B","3.1_ref",9,"025026",2,15,17,3
1358600,1368270,"A","3.2_ref",10,"025026",19,4,23,3
1419640,1433500,"B","3.3_ref",15,"025026",16,14,30,3
1438160,1452160,"A","3.4_ref",12,"025026",19,9,28,3
1461230,1471140,"B","3.5_ref",1,"025026",1,30,31,3
1476810,1489910,"A","3.6_ref",4,"025026",28,9,37,3
1499990,1511060,"B","3.7_ref",7,"025026",17,12,29,3
1516080,1536500,"A","3.8_ref",16,"025026",47,15,62,3
1551640,1558570,"B","3.9_ref",13,"025026",2,16,18,3
1566850,1571810,"A","3.10_ref",2,"025026",3,2,5,3
1594800,1606070,"B","3.11_ref",11,"025026",13,19,32,3
1615790,1624920,"A","3.12_ref",6,"025026",15,6,21,3
1633380,1639420,"B","3.13_ref",5,"025026",5,10,15,3
1646880,1671710,"A","3.14_ref",8,"025026",56,17,73,3
1684430,1690260,"B","3.15_ref",3,"025026",5,12,17,3
1697850,1705530,"A","3.16_ref",14,"025026",16,3,19,3
1717000,1723830,"B","4.1_ref",10,"025026",3,10,13,4
1732850,1751690,"A","4.2_ref",15,"025026",27,12,39,4
1758640,1764470,"B","4.3_ref",6,"025026",2,10,12,4
1777950,1794410,"A","4.4_ref",1,"025026",26,12,38,4
1800880,1840000,"B","4.5_ref",16,"025026",27,51,78,4
1844740,1851700,"A","4.6_ref",13,"025026",8,3,11,4
1864580,1870850,"B","4.7_ref",12,"025026",2,9,11,4
1880150,1887700,"A","4.8_ref",7,"025026",11,4,15,4
1900610,1906560,"B","4.9_ref",2,"025026",2,6,8,4
1916670,1926880,"A","4.10_ref",9,"025026",13,3,16,4
1948180,1960140,"B","4.11_ref",14,"025026",16,9,25,4
1977070,1986450,"A","4.12_ref",5,"025026",7,5,12,4
2006040,2016560,"B","4.13_ref",8,"025026",4,10,14,4
2024230,2035410,"A","4.14_ref",11,"025026",24,4,28,4
2049030,2057030,"B","4.15_ref",4,"025026",7,15,22,4
2068660,2074460,"A","4.16_ref",3,"025026",10,2,12,4
2081740,2085910,"B","5.1_ref",7,"025026",3,4,7,5
2097330,2104920,"A","5.2_ref",6,"025026",10,4,14,5
2114790,2121580,"B","5.3_ref",11,"025026",2,14,16,5
2130610,2140890,"A","5.4_ref",10,"025026",13,4,17,5
2152070,2158400,"B","5.5_ref",9,"025026",3,15,18,5
2170540,2179080,"A","5.6_ref",4,"025026",18,5,23,5
2198650,2203300,"B","5.7_ref",13,"025026",2,8,10,5
2209840,2217710,"A","5.8_ref",12,"025026",3,7,10,5
2237970,2248570,"B","5.9_ref",1,"025026",7,21,28,5
2256310,2264060,"A","5.10_ref",8,"025026",11,3,14,5
2271400,2278710,"B","5.11_ref",15,"025026",5,10,15,5
2289220,2297490,"A","5.12_ref",14,"025026",11,3,14,5
2305330,2310470,"B","5.13_ref",5,"025026",6,6,12,5
2316390,2328790,"A","5.14_ref",16,"025026",16,3,19,5
2332630,2339050,"B","5.15_ref",3,"025026",5,8,13,5
2345820,2351540,"A","5.16_ref",2,"025026",2,3,5,5
2354510,2366080,"B","6.1_ref",10,"025026",14,12,26,6
2374160,2382250,"A","6.2_ref",11,"025026",14,3,17,6
2395350,2402890,"B","6.3_ref",8,"025026",9,8,17,6
2408070,2414730,"A","6.4_ref",7,"025026",5,2,7,6
2431350,2441070,"B","6.5_ref",4,"025026",7,15,22,6
2447990,2456420,"A","6.6_ref",3,"025026",12,3,15,6
2461910,2468250,"B","6.7_ref",14,"025026",2,7,9,6
2473290,2480370,"A","6.8_ref",13,"025026",7,5,12,6
2486000,2491060,"B","6.9_ref",2,"025026",3,5,8,6
2498230,2506750,"A","6.10_ref",9,"025026",16,3,19,6
2511300,2516140,"B","6.11_ref",6,"025026",2,11,13,6
2522440,2529830,"A","6.12_ref",1,"025026",14,3,17,6
2539630,2544410,"B","6.13_ref",16,"025026",0,11,11,6
2563640,2568670,"A","6.14_ref",5,"025026",4,0,4,6
2584130,2590890,"B","6.15_ref",12,"025026",7,10,17,6
2596110,2605230,"A","6.16_ref",15,"025026",13,3,16,6
40640,69070,"B","1.1_ref",9,"027028",19,50,69,1
103160,158530,"A","1.2_ref",6,"027028",108,64,172,1
185740,216470,"B","1.3_ref",15,"027028",19,62,81,1
251420,274880,"A","1.4_ref",14,"027028",50,28,78,1
291690,318190,"B","1.5_ref",13,"027028",30,48,78,1
360790,403990,"A","1.6_ref",16,"027028",110,30,140,1
418480,503160,"B","1.7_ref",11,"027028",88,139,227,1
522140,590450,"A","1.8_ref",8,"027028",156,54,210,1
653050,675610,"B","1.9_ref",3,"027028",27,51,78,1
682660,695350,"A","1.10_ref",10,"027028",29,5,34,1
713680,786990,"B","1.11_ref",5,"027028",57,130,187,1
805290,826740,"A","1.12_ref",4,"027028",58,18,76,1
840990,857460,"B","1.13_ref",7,"027028",14,27,41,1
869210,894420,"A","1.14_ref",2,"027028",45,22,67,1
903790,915740,"B","1.15_ref",1,"027028",19,25,44,1
930340,956300,"A","1.16_ref",12,"027028",60,15,75,1
969430,981880,"B","2.1_ref",14,"027028",10,20,30,2
988300,1007760,"A","2.2_ref",9,"027028",46,5,51,2
1019350,1061490,"B","2.3_ref",16,"027028",37,76,113,2
1075150,1084480,"A","2.4_ref",3,"027028",8,8,16,2
1095640,1108650,"B","2.5_ref",10,"027028",16,19,35,2
1137840,1152620,"A","2.6_ref",11,"027028",37,9,46,2
1161080,1200810,"B","2.7_ref",12,"027028",67,43,110,2
1228700,1301110,"A","2.8_ref",7,"027028",151,51,202,2
1321360,1333130,"B","2.9_ref",6,"027028",10,22,32,2
1348510,1354500,"A","2.10_ref",13,"027028",10,5,15,2
1364580,1376440,"B","2.11_ref",2,"027028",20,18,38,2
1401850,1411640,"A","2.12_ref",15,"027028",12,4,16,2
1425590,1444580,"B","2.13_ref",8,"027028",14,29,43,2
1454980,1469770,"A","2.14_ref",1,"027028",24,6,30,2
1476910,1498950,"B","2.15_ref",4,"027028",36,38,74,2
1520150,1529700,"A","2.16_ref",5,"027028",16,3,19,2
1548330,1599410,"B","3.1_ref",9,"027028",44,89,133,3
1616910,1623550,"A","3.2_ref",10,"027028",8,8,16,3
1646090,1667330,"B","3.3_ref",15,"027028",10,5,15,3
1674410,1687470,"A","3.4_ref",12,"027028",26,8,34,3
1699410,1708830,"B","3.5_ref",1,"027028",12,15,27,3
1719990,1726320,"A","3.6_ref",4,"027028",6,3,9,3
1733560,1745900,"B","3.7_ref",7,"027028",21,17,38,3
1758930,1778830,"A","3.8_ref",16,"027028",35,25,60,3
1801350,1807120,"B","3.9_ref",13,"027028",4,4,8,3
1828360,1836830,"A","3.10_ref",2,"027028",17,7,24,3
1856310,1880940,"B","3.11_ref",11,"027028",39,32,71,3
1889620,1895320,"A","3.12_ref",6,"027028",6,5,11,3
1908480,1919180,"B","3.13_ref",5,"027028",3,9,12,3
1930530,1937400,"A","3.14_ref",8,"027028",2,3,5,3
1968560,1974730,"B","3.15_ref",3,"027028",3,3,6,3
1991740,1998560,"A","3.16_ref",14,"027028",8,4,12,3
2009710,2017020,"B","4.1_ref",10,"027028",2,5,7,4
2035430,2046800,"A","4.2_ref",15,"027028",8,17,25,4
2052510,2059020,"B","4.3_ref",6,"027028",2,5,7,4
2082360,2094330,"A","4.4_ref",1,"027028",14,4,18,4
2102780,2114350,"B","4.5_ref",16,"027028",4,18,22,4
2125660,2131050,"A","4.6_ref",13,"027028",6,3,9,4
2148240,2156310,"B","4.7_ref",12,"027028",3,6,9,4
2166720,2176920,"A","4.8_ref",7,"027028",3,11,14,4
2212270,2217440,"B","4.9_ref",2,"027028",5,7,12,4
2257200,2269330,"A","4.10_ref",9,"027028",18,16,34,4
2287920,2295470,"B","4.11_ref",14,"027028",3,7,10,4
2319370,2324310,"A","4.12_ref",5,"027028",4,4,8,4
2342680,2363490,"B","4.13_ref",8,"027028",32,19,51,4
2379060,2394540,"A","4.14_ref",11,"027028",26,6,32,4
2401360,2407760,"B","4.15_ref",4,"027028",4,5,9,4
2419790,2425390,"A","4.16_ref",3,"027028",3,3,6,4
2441010,2446380,"B","5.1_ref",7,"027028",5,5,10,5
2459190,2468210,"A","5.2_ref",6,"027028",4,7,11,5
2480410,2515280,"B","5.3_ref",11,"027028",36,42,78,5
2538570,2550130,"A","5.4_ref",10,"027028",7,17,24,5
2567540,2573000,"B","5.5_ref",9,"027028",3,3,6,5
2587790,2594810,"A","5.6_ref",4,"027028",8,3,11,5
2616490,2622570,"B","5.7_ref",13,"027028",3,5,8,5
2639710,2645330,"A","5.8_ref",12,"027028",8,1,9,5
2656200,2669260,"B","5.9_ref",1,"027028",4,9,13,5
2698780,2708570,"A","5.10_ref",8,"027028",20,4,24,5
2731200,2738910,"B","5.11_ref",15,"027028",2,4,6,5
2755540,2760120,"A","5.12_ref",14,"027028",4,4,8,5
2776540,2786650,"B","5.13_ref",5,"027028",1,6,7,5
2802740,2816840,"A","5.14_ref",16,"027028",21,3,24,5
2831310,2837680,"B","5.15_ref",3,"027028",2,3,5,5
2859370,2868020,"A","5.16_ref",2,"027028",13,6,19,5
2874920,2886320,"B","6.1_ref",10,"027028",4,6,10,6
2905850,2914000,"A","6.2_ref",11,"027028",14,4,18,6
2930120,2937920,"B","6.3_ref",8,"027028",3,15,18,6
2956890,2964800,"A","6.4_ref",7,"027028",4,9,13,6
2981500,2987010,"B","6.5_ref",4,"027028",2,4,6,6
3001930,3008200,"A","6.6_ref",3,"027028",2,3,5,6
3016420,3024470,"B","6.7_ref",14,"027028",2,5,7,6
3037330,3041880,"A","6.8_ref",13,"027028",5,2,7,6
3056150,3063260,"B","6.9_ref",2,"027028",1,5,6,6
3091920,3099250,"A","6.10_ref",9,"027028",3,6,9,6
3110590,3117010,"B","6.11_ref",6,"027028",3,4,7,6
3130360,3137890,"A","6.12_ref",1,"027028",16,3,19,6
3146840,3163020,"B","6.13_ref",16,"027028",13,7,20,6
3173340,3181070,"A","6.14_ref",5,"027028",9,5,14,6
3188540,3194880,"B","6.15_ref",12,"027028",5,7,12,6
3208690,3219090,"A","6.16_ref",15,"027028",13,8,21,6
2410,51590,"B","1.1_ref",9,"035036",66,85,151,1
76450,107160,"A","1.2_ref",6,"035036",65,36,101,1
138340,175020,"B","1.3_ref",15,"035036",82,37,119,1
190470,212170,"A","1.4_ref",14,"035036",55,15,70,1
220100,235150,"B","1.5_ref",13,"035036",18,29,47,1
299280,350150,"A","1.6_ref",16,"035036",112,46,158,1
364400,428500,"B","1.7_ref",11,"035036",73,98,171,1
463940,536730,"A","1.8_ref",8,"035036",140,18,158,1
552320,577470,"B","1.9_ref",3,"035036",40,46,86,1
590430,608060,"A","1.10_ref",10,"035036",33,19,52,1
617930,647720,"B","1.11_ref",5,"035036",21,68,89,1
672150,687680,"A","1.12_ref",4,"035036",26,14,40,1
720420,739050,"B","1.13_ref",7,"035036",14,41,55,1
757730,775160,"A","1.14_ref",2,"035036",36,18,54,1
793030,817570,"B","1.15_ref",1,"035036",19,48,67,1
829410,852580,"A","1.16_ref",12,"035036",41,12,53,1
860580,886870,"B","2.1_ref",14,"035036",40,36,76,2
896210,912570,"A","2.2_ref",9,"035036",36,10,46,2
924960,936150,"B","2.3_ref",16,"035036",17,12,29,2
945580,956150,"A","2.4_ref",3,"035036",16,4,20,2
975460,984340,"B","2.5_ref",10,"035036",7,5,12,2
1000570,1017870,"A","2.6_ref",11,"035036",18,9,27,2
1025190,1035630,"B","2.7_ref",12,"035036",14,11,25,2
1067710,1076150,"A","2.8_ref",7,"035036",18,3,21,2
1093980,1106540,"B","2.9_ref",6,"035036",20,15,35,2
1119280,1126510,"A","2.10_ref",13,"035036",6,4,10,2
1130560,1146150,"B","2.11_ref",2,"035036",7,24,31,2
1158040,1169580,"A","2.12_ref",15,"035036",22,8,30,2
1177610,1187970,"B","2.13_ref",8,"035036",18,9,27,2
1194100,1202920,"A","2.14_ref",1,"035036",17,4,21,2
1210890,1224260,"B","2.15_ref",4,"035036",11,16,27,2
1237990,1253260,"A","2.16_ref",5,"035036",19,10,29,2
1259130,1273610,"B","3.1_ref",9,"035036",13,21,34,3
1277990,1283650,"A","3.2_ref",10,"035036",6,4,10,3
1320540,1332720,"B","3.3_ref",15,"035036",15,18,33,3
1337330,1343310,"A","3.4_ref",12,"035036",7,4,11,3
1359210,1365700,"B","3.5_ref",1,"035036",4,6,10,3
1384700,1397450,"A","3.6_ref",4,"035036",12,3,15,3
1400640,1422240,"B","3.7_ref",7,"035036",30,10,40,3
1438490,1452610,"A","3.8_ref",16,"035036",9,3,12,3
1479970,1485960,"B","3.9_ref",13,"035036",3,3,6,3
1497210,1504540,"A","3.10_ref",2,"035036",10,3,13,3
1515220,1523380,"B","3.11_ref",11,"035036",4,4,8,3
1531090,1536970,"A","3.12_ref",6,"035036",8,3,11,3
1545160,1553190,"B","3.13_ref",5,"035036",4,9,13,3
1563170,1574880,"A","3.14_ref",8,"035036",17,5,22,3
1581970,1591060,"B","3.15_ref",3,"035036",3,10,13,3
1599910,1606040,"A","3.16_ref",14,"035036",7,3,10,3
1620670,1628400,"B","4.1_ref",10,"035036",12,4,16,4
1633550,1644490,"A","4.2_ref",15,"035036",17,4,21,4
1649050,1655120,"B","4.3_ref",6,"035036",4,5,9,4
1697440,1703310,"A","4.4_ref",1,"035036",7,2,9,4
1711410,1717460,"B","4.5_ref",16,"035036",3,5,8,4
1729030,1733470,"A","4.6_ref",13,"035036",3,2,5,4
1743720,1751740,"B","4.7_ref",12,"035036",5,5,10,4
1763980,1774340,"A","4.8_ref",7,"035036",9,3,12,4
1787930,1796250,"B","4.9_ref",2,"035036",5,7,12,4
1802540,1813480,"A","4.10_ref",9,"035036",14,3,17,4
1821270,1830170,"B","4.11_ref",14,"035036",4,8,12,4
1847640,1854840,"A","4.12_ref",5,"035036",17,2,19,4
1866920,1873630,"B","4.13_ref",8,"035036",4,4,8,4
1882680,1890810,"A","4.14_ref",11,"035036",13,3,16,4
1911490,1919040,"B","4.15_ref",4,"035036",5,12,17,4
1925550,1933400,"A","4.16_ref",3,"035036",5,4,9,4
1937160,1949560,"B","5.1_ref",7,"035036",6,10,16,5
1962790,1970750,"A","5.2_ref",6,"035036",6,5,11,5
1980300,1986840,"B","5.3_ref",11,"035036",5,3,8,5
2001280,2008930,"A","5.4_ref",10,"035036",2,3,5,5
2018610,2028960,"B","5.5_ref",9,"035036",4,8,12,5
2038570,2045130,"A","5.6_ref",4,"035036",10,3,13,5
2050040,2054950,"B","5.7_ref",13,"035036",9,1,10,5
2061310,2069930,"A","5.8_ref",12,"035036",8,3,11,5
2079060,2084360,"B","5.9_ref",1,"035036",8,4,12,5
2091740,2099720,"A","5.10_ref",8,"035036",8,4,12,5
2107890,2117650,"B","5.11_ref",15,"035036",5,9,14,5
2130230,2134890,"A","5.12_ref",14,"035036",6,3,9,5
2146820,2155360,"B","5.13_ref",5,"035036",5,6,11,5
2163460,2169580,"A","5.14_ref",16,"035036",7,3,10,5
2176530,2183160,"B","5.15_ref",3,"035036",5,5,10,5
2189470,2198630,"A","5.16_ref",2,"035036",8,2,10,5
2202210,2207980,"B","6.1_ref",10,"035036",4,2,6,6
2219100,2224710,"A","6.2_ref",11,"035036",8,3,11,6
2240490,2246420,"B","6.3_ref",8,"035036",4,4,8,6
2258380,2267740,"A","6.4_ref",7,"035036",10,4,14,6
2275750,2284030,"B","6.5_ref",4,"035036",2,10,12,6
2301530,2308600,"A","6.6_ref",3,"035036",4,3,7,6
2317570,2324560,"B","6.7_ref",14,"035036",4,4,8,6
2335170,2339790,"A","6.8_ref",13,"035036",4,3,7,6
2349830,2356330,"B","6.9_ref",2,"035036",3,4,7,6
2377440,2388240,"A","6.10_ref",9,"035036",8,1,9,6
2393750,2399640,"B","6.11_ref",6,"035036",8,4,12,6
2407830,2413260,"A","6.12_ref",1,"035036",9,2,11,6
2426200,2432480,"B","6.13_ref",16,"035036",7,5,12,6
2437100,2445720,"A","6.14_ref",5,"035036",7,3,10,6
2448880,2455530,"B","6.15_ref",12,"035036",5,5,10,6
2464540,2474000,"A","6.16_ref",15,"035036",14,4,18,6
4860,44250,"B","1.1_ref",9,"037038",45,52,97,1
63770,102540,"A","1.2_ref",6,"037038",83,24,107,1
119590,135800,"B","1.3_ref",15,"037038",12,26,38,1
145280,173840,"A","1.4_ref",14,"037038",57,15,72,1
184600,201050,"B","1.5_ref",13,"037038",11,24,35,1
223710,263800,"A","1.6_ref",16,"037038",94,22,116,1
285220,308740,"B","1.7_ref",11,"037038",14,44,58,1
319410,347730,"A","1.8_ref",8,"037038",57,17,74,1
362230,380110,"B","1.9_ref",3,"037038",6,43,49,1
388260,434070,"A","1.10_ref",10,"037038",95,18,113,1
442550,481470,"B","1.11_ref",5,"037038",30,50,80,1
490010,517630,"A","1.12_ref",4,"037038",56,11,67,1
530130,550420,"B","1.13_ref",7,"037038",13,44,57,1
562590,585440,"A","1.14_ref",2,"037038",43,17,60,1
594520,611740,"B","1.15_ref",1,"037038",10,39,49,1
627080,653580,"A","1.16_ref",12,"037038",41,18,59,1
665490,678460,"B","2.1_ref",14,"037038",5,24,29,2
692320,713870,"A","2.2_ref",9,"037038",58,7,65,2
725670,754540,"B","2.3_ref",16,"037038",18,54,72,2
760130,770590,"A","2.4_ref",3,"037038",22,5,27,2
782170,797050,"B","2.5_ref",10,"037038",3,27,30,2
809370,826980,"A","2.6_ref",11,"037038",39,11,50,2
837680,844910,"B","2.7_ref",12,"037038",6,9,15,2
853840,869230,"A","2.8_ref",7,"037038",26,10,36,2
881110,902650,"B","2.9_ref",6,"037038",17,39,56,2
924690,936550,"A","2.10_ref",13,"037038",20,5,25,2
944560,954170,"B","2.11_ref",2,"037038",6,17,23,2
963150,976720,"A","2.12_ref",15,"037038",24,6,30,2
989470,996970,"B","2.13_ref",8,"037038",9,6,15,2
1002940,1016720,"A","2.14_ref",1,"037038",31,5,36,2
1024520,1032800,"B","2.15_ref",4,"037038",6,16,22,2
1040190,1055000,"A","2.16_ref",5,"037038",19,14,33,2
1064090,1071650,"B","3.1_ref",9,"037038",6,7,13,3
1079380,1117020,"A","3.2_ref",10,"037038",66,16,82,3
1135800,1143610,"B","3.3_ref",15,"037038",4,11,15,3
1149390,1155910,"A","3.4_ref",12,"037038",12,3,15,3
1162040,1171620,"B","3.5_ref",1,"037038",5,21,26,3
1181500,1189970,"A","3.6_ref",4,"037038",8,6,14,3
1198520,1210150,"B","3.7_ref",7,"037038",11,17,28,3
1215430,1240220,"A","3.8_ref",16,"037038",54,10,64,3
1256020,1270370,"B","3.9_ref",13,"037038",11,23,34,3
1281700,1288480,"A","3.10_ref",2,"037038",11,4,15,3
1297520,1323070,"B","3.11_ref",11,"037038",15,42,57,3
1331640,1343660,"A","3.12_ref",6,"037038",24,8,32,3
1355370,1361880,"B","3.13_ref",5,"037038",3,7,10,3
1368050,1377740,"A","3.14_ref",8,"037038",8,9,17,3
1388860,1394570,"B","3.15_ref",3,"037038",4,3,7,3
1400630,1409740,"A","3.16_ref",14,"037038",18,3,21,3
1422880,1434400,"B","4.1_ref",10,"037038",5,20,25,4
1441830,1455320,"A","4.2_ref",15,"037038",22,4,26,4
1463080,1469940,"B","4.3_ref",6,"037038",5,7,12,4
1479160,1493100,"A","4.4_ref",1,"037038",27,3,30,4
1500980,1508910,"B","4.5_ref",16,"037038",4,14,18,4
1519080,1527460,"A","4.6_ref",13,"037038",16,2,18,4
1535930,1546520,"B","4.7_ref",12,"037038",6,18,24,4
1554910,1565370,"A","4.8_ref",7,"037038",20,3,23,4
1573440,1580650,"B","4.9_ref",2,"037038",9,4,13,4
1590980,1598160,"A","4.10_ref",9,"037038",8,3,11,4
1609310,1630990,"B","4.11_ref",14,"037038",25,25,50,4
1639870,1648280,"A","4.12_ref",5,"037038",19,3,22,4
1658650,1664830,"B","4.13_ref",8,"037038",3,3,6,4
1674030,1690730,"A","4.14_ref",11,"037038",37,10,47,4
1699430,1707350,"B","4.15_ref",4,"037038",5,4,9,4
1718950,1723910,"A","4.16_ref",3,"037038",6,2,8,4
1727820,1734560,"B","5.1_ref",7,"037038",3,11,14,5
1744270,1752570,"A","5.2_ref",6,"037038",15,2,17,5
1761050,1776450,"B","5.3_ref",11,"037038",8,24,32,5
1787490,1801270,"A","5.4_ref",10,"037038",29,2,31,5
1812500,1818470,"B","5.5_ref",9,"037038",4,4,8,5
1826620,1833200,"A","5.6_ref",4,"037038",3,4,7,5
1841060,1850030,"B","5.7_ref",13,"037038",3,10,13,5
1862150,1869720,"A","5.8_ref",12,"037038",13,2,15,5
1876490,1886030,"B","5.9_ref",1,"037038",8,16,24,5
1893990,1901010,"A","5.10_ref",8,"037038",6,5,11,5
1909240,1917660,"B","5.11_ref",15,"037038",5,14,19,5
1925640,1935640,"A","5.12_ref",14,"037038",13,5,18,5
1967400,1975180,"B","5.13_ref",5,"037038",9,9,18,5
1980730,1989370,"A","5.14_ref",16,"037038",7,8,15,5
1996540,2005020,"B","5.15_ref",3,"037038",13,5,18,5
2011920,2016880,"A","5.16_ref",2,"037038",4,2,6,5
2020560,2031540,"B","6.1_ref",10,"037038",3,23,26,6
2048320,2058360,"A","6.2_ref",11,"037038",21,2,23,6
2068370,2073090,"B","6.3_ref",8,"037038",4,4,8,6
2081260,2090720,"A","6.4_ref",7,"037038",18,2,20,6
2099160,2106300,"B","6.5_ref",4,"037038",7,4,11,6
2113050,2119890,"A","6.6_ref",3,"037038",6,2,8,6
2128700,2139470,"B","6.7_ref",14,"037038",4,9,13,6
2145420,2151980,"A","6.8_ref",13,"037038",12,2,14,6
2159790,2166270,"B","6.9_ref",2,"037038",3,4,7,6
2172970,2178980,"A","6.10_ref",9,"037038",5,3,8,6
2188520,2195660,"B","6.11_ref",6,"037038",4,9,13,6
2203580,2211680,"A","6.12_ref",1,"037038",15,2,17,6
2219580,2225500,"B","6.13_ref",16,"037038",3,7,10,6
2229300,2239170,"A","6.14_ref",5,"037038",18,2,20,6
2242370,2253200,"B","6.15_ref",12,"037038",9,8,17,6
2266180,2277720,"A","6.16_ref",15,"037038",18,4,22,6
3760,27330,"B","1.1_ref",9,"039040",17,41,58,1
42570,55680,"A","1.2_ref",6,"039040",35,7,42,1
119780,154800,"B","1.3_ref",15,"039040",28,65,93,1
168970,189610,"A","1.4_ref",14,"039040",38,22,60,1
208220,221110,"B","1.5_ref",13,"039040",21,16,37,1
245380,263250,"A","1.6_ref",16,"039040",43,12,55,1
291360,308060,"B","1.7_ref",11,"039040",16,32,48,1
321430,362430,"A","1.8_ref",8,"039040",69,46,115,1
383570,394460,"B","1.9_ref",3,"039040",10,17,27,1
409790,438370,"A","1.10_ref",10,"039040",53,16,69,1
456430,473930,"B","1.11_ref",5,"039040",16,29,45,1
486420,518780,"A","1.12_ref",4,"039040",50,29,79,1
527990,539090,"B","1.13_ref",7,"039040",20,19,39,1
549860,558440,"A","1.14_ref",2,"039040",12,3,15,1
571620,583480,"B","1.15_ref",1,"039040",25,18,43,1
598970,618130,"A","1.16_ref",12,"039040",37,10,47,1
631800,643250,"B","2.1_ref",14,"039040",9,18,27,2
662630,681680,"A","2.2_ref",9,"039040",34,4,38,2
692450,711150,"B","2.3_ref",16,"039040",13,36,49,2
715740,724230,"A","2.4_ref",3,"039040",7,9,16,2
740100,751270,"B","2.5_ref",10,"039040",18,11,29,2
758260,767810,"A","2.6_ref",11,"039040",13,8,21,2
779450,792850,"B","2.7_ref",12,"039040",13,18,31,2
832970,840270,"A","2.8_ref",7,"039040",8,1,9,2
850480,868740,"B","2.9_ref",6,"039040",35,24,59,2
877580,887810,"A","2.10_ref",13,"039040",16,5,21,2
900260,908250,"B","2.11_ref",2,"039040",8,9,17,2
913940,934530,"A","2.12_ref",15,"039040",37,12,49,2
939000,955440,"B","2.13_ref",8,"039040",15,41,56,2
961220,970060,"A","2.14_ref",1,"039040",13,6,19,2
974640,985520,"B","2.15_ref",4,"039040",10,22,32,2
991420,1001830,"A","2.16_ref",5,"039040",20,6,26,2
1006960,1027880,"B","3.1_ref",9,"039040",11,33,44,3
1051180,1060770,"A","3.2_ref",10,"039040",21,3,24,3
1078100,1092870,"B","3.3_ref",15,"039040",17,28,45,3
1100350,1108200,"A","3.4_ref",12,"039040",12,2,14,3
1138640,1148130,"B","3.5_ref",1,"039040",10,15,25,3
1179730,1187970,"A","3.6_ref",4,"039040",5,8,13,3
1191890,1205600,"B","3.7_ref",7,"039040",14,8,22,3
1222200,1228400,"A","3.8_ref",16,"039040",15,2,17,3
1240860,1250080,"B","3.9_ref",13,"039040",6,16,22,3
1257850,1264890,"A","3.10_ref",2,"039040",7,8,15,3
1276460,1287500,"B","3.11_ref",11,"039040",3,22,25,3
1299020,1307830,"A","3.12_ref",6,"039040",10,5,15,3
1318260,1325490,"B","3.13_ref",5,"039040",4,12,16,3
1365060,1377000,"A","3.14_ref",8,"039040",9,3,12,3
1391730,1401600,"B","3.15_ref",3,"039040",11,14,25,3
1405890,1414660,"A","3.16_ref",14,"039040",20,2,22,3
1422470,1445370,"B","4.1_ref",10,"039040",28,44,72,4
1453890,1465450,"A","4.2_ref",15,"039040",10,12,22,4
1470700,1476560,"B","4.3_ref",6,"039040",4,6,10,4
1496090,1506650,"A","4.4_ref",1,"039040",11,2,13,4
1536300,1545700,"B","4.5_ref",16,"039040",4,17,21,4
1550110,1556430,"A","4.6_ref",13,"039040",13,2,15,4
1563490,1574110,"B","4.7_ref",12,"039040",7,7,14,4
1580600,1590720,"A","4.8_ref",7,"039040",6,4,10,4
1595070,1603710,"B","4.9_ref",2,"039040",2,6,8,4
1610320,1624310,"A","4.10_ref",9,"039040",28,2,30,4
1632190,1646940,"B","4.11_ref",14,"039040",8,17,25,4
1652600,1666510,"A","4.12_ref",5,"039040",10,3,13,4
1670370,1678020,"B","4.13_ref",8,"039040",5,7,12,4
1682460,1688570,"A","4.14_ref",11,"039040",14,2,16,4
1692470,1697830,"B","4.15_ref",4,"039040",3,5,8,4
1702470,1708000,"A","4.16_ref",3,"039040",5,1,6,4
1711670,1718100,"B","5.1_ref",7,"039040",3,7,10,5
1745200,1750630,"A","5.2_ref",6,"039040",5,3,8,5
1764230,1777430,"B","5.3_ref",11,"039040",13,13,26,5
1804460,1812450,"A","5.4_ref",10,"039040",6,4,10,5
1832250,1845390,"B","5.5_ref",9,"039040",11,15,26,5
1854830,1863080,"A","5.6_ref",4,"039040",7,6,13,5
1869980,1875100,"B","5.7_ref",13,"039040",5,8,13,5
1879900,1887480,"A","5.8_ref",12,"039040",13,1,14,5
1903330,1910560,"B","5.9_ref",1,"039040",2,14,16,5
1931610,1937540,"A","5.10_ref",8,"039040",7,1,8,5
1948170,1953980,"B","5.11_ref",15,"039040",3,7,10,5
1962260,1968530,"A","5.12_ref",14,"039040",11,1,12,5
1982790,1989090,"B","5.13_ref",5,"039040",5,14,19,5
1996470,2004210,"A","5.14_ref",16,"039040",13,3,16,5
2010410,2018560,"B","5.15_ref",3,"039040",3,13,16,5
2032720,2043120,"A","5.16_ref",2,"039040",12,4,16,5
2045460,2062030,"B","6.1_ref",10,"039040",10,14,24,6
2070520,2082950,"A","6.2_ref",11,"039040",7,11,18,6
2225750,2235310,"B","6.3_ref",8,"039040",9,9,18,6
2242630,2245640,"A","6.4_ref",7,"039040",0,1,1,6
2256060,2259930,"B","6.5_ref",4,"039040",3,5,8,6
2302210,2307570,"A","6.6_ref",3,"039040",10,2,12,6
2324100,2336660,"B","6.7_ref",14,"039040",12,12,24,6
2339420,2345220,"A","6.8_ref",13,"039040",8,2,10,6
2354750,2360960,"B","6.9_ref",2,"039040",7,5,12,6
2368370,2375270,"A","6.10_ref",9,"039040",12,5,17,6
2383420,2389500,"B","6.11_ref",6,"039040",7,3,10,6
2414480,2422530,"A","6.12_ref",1,"039040",7,3,10,6
2430000,2438070,"B","6.13_ref",16,"039040",4,18,22,6
2441200,2451160,"A","6.14_ref",5,"039040",8,4,12,6
2453880,2461620,"B","6.15_ref",12,"039040",8,9,17,6
2469570,2481760,"A","6.16_ref",15,"039040",17,6,23,6
3230,46260,"B","1.1_ref",9,"041042",44,38,82,1
73990,99060,"A","1.2_ref",6,"041042",49,17,66,1
145460,178430,"B","1.3_ref",15,"041042",35,55,90,1
223180,250300,"A","1.4_ref",14,"041042",44,24,68,1
268580,300790,"B","1.5_ref",13,"041042",34,61,95,1
324830,399810,"A","1.6_ref",16,"041042",146,66,212,1
448850,481890,"B","1.7_ref",11,"041042",32,84,116,1
547680,574860,"A","1.8_ref",8,"041042",66,6,72,1
630570,658120,"B","1.9_ref",3,"041042",34,34,68,1
672280,696070,"A","1.10_ref",10,"041042",49,9,58,1
717350,748030,"B","1.11_ref",5,"041042",26,60,86,1
768510,810960,"A","1.12_ref",4,"041042",79,35,114,1
839400,874410,"B","1.13_ref",7,"041042",44,52,96,1
898860,945020,"A","1.14_ref",2,"041042",99,13,112,1
959200,985100,"B","1.15_ref",1,"041042",22,58,80,1
1002960,1031740,"A","1.16_ref",12,"041042",70,9,79,1
1075540,1111750,"B","2.1_ref",14,"041042",27,53,80,2
1120290,1137630,"A","2.2_ref",9,"041042",32,4,36,2
1157260,1172440,"B","2.3_ref",16,"041042",12,32,44,2
1197180,1275500,"A","2.4_ref",3,"041042",110,53,163,2
1300490,1308110,"B","2.5_ref",10,"041042",8,5,13,2
1326640,1349750,"A","2.6_ref",11,"041042",45,4,49,2
1374260,1391730,"B","2.7_ref",12,"041042",11,29,40,2
1418900,1437560,"A","2.8_ref",7,"041042",39,3,42,2
1453080,1464460,"B","2.9_ref",6,"041042",13,13,26,2
1490450,1501730,"A","2.10_ref",13,"041042",23,5,28,2
1517070,1535030,"B","2.11_ref",2,"041042",22,23,45,2
1551560,1566850,"A","2.12_ref",15,"041042",32,6,38,2
1582870,1609980,"B","2.13_ref",8,"041042",27,58,85,2
1628880,1643420,"A","2.14_ref",1,"041042",29,4,33,2
1661160,1676820,"B","2.15_ref",4,"041042",12,29,41,2
1690750,1704170,"A","2.16_ref",5,"041042",25,4,29,2
1720380,1740340,"B","3.1_ref",9,"041042",23,21,44,3
1765320,1771800,"A","3.2_ref",10,"041042",7,4,11,3
1798150,1812990,"B","3.3_ref",15,"041042",7,22,29,3
1828850,1838980,"A","3.4_ref",12,"041042",13,4,17,3
1856870,1869270,"B","3.5_ref",1,"041042",6,17,23,3
1886040,1894600,"A","3.6_ref",4,"041042",8,5,13,3
1911110,1928140,"B","3.7_ref",7,"041042",10,19,29,3
1939560,1956520,"A","3.8_ref",16,"041042",35,2,37,3
1971310,1995530,"B","3.9_ref",13,"041042",36,24,60,3
2014660,2023880,"A","3.10_ref",2,"041042",16,3,19,3
2049830,2073890,"B","3.11_ref",11,"041042",18,33,51,3
2093630,2099370,"A","3.12_ref",6,"041042",9,3,12,3
2123570,2135600,"B","3.13_ref",5,"041042",13,14,27,3
2144110,2163570,"A","3.14_ref",8,"041042",48,3,51,3
2184250,2199080,"B","3.15_ref",3,"041042",7,27,34,3
2233020,2246260,"A","3.16_ref",14,"041042",27,3,30,3
2284420,2293670,"B","4.1_ref",10,"041042",12,3,15,4
2310020,2327550,"A","4.2_ref",15,"041042",26,5,31,4
2344170,2352700,"B","4.3_ref",6,"041042",10,6,16,4
2371420,2378110,"A","4.4_ref",1,"041042",6,4,10,4
2403540,2432020,"B","4.5_ref",16,"041042",29,33,62,4
2448520,2454290,"A","4.6_ref",13,"041042",10,2,12,4
2476010,2488500,"B","4.7_ref",12,"041042",5,14,19,4
2500590,2510420,"A","4.8_ref",7,"041042",17,3,20,4
2526400,2536630,"B","4.9_ref",2,"041042",9,11,20,4
2561160,2572490,"A","4.10_ref",9,"041042",18,6,24,4
2591820,2605490,"B","4.11_ref",14,"041042",13,10,23,4
2632140,2642190,"A","4.12_ref",5,"041042",18,3,21,4
2659330,2675730,"B","4.13_ref",8,"041042",17,26,43,4
2693920,2713670,"A","4.14_ref",11,"041042",44,4,48,4
2729990,2737800,"B","4.15_ref",4,"041042",6,9,15,4
2755410,2764170,"A","4.16_ref",3,"041042",17,2,19,4
2774890,2780490,"B","5.1_ref",7,"041042",5,5,10,5
2807590,2812600,"A","5.2_ref",6,"041042",6,3,9,5
2825900,2842150,"B","5.3_ref",11,"041042",23,7,30,5
2890130,2894940,"A","5.4_ref",10,"041042",7,2,9,5
2907420,2917020,"B","5.5_ref",9,"041042",7,4,11,5
2937900,2946650,"A","5.6_ref",4,"041042",7,3,10,5
2972230,2983720,"B","5.7_ref",13,"041042",8,12,20,5
2993700,2999340,"A","5.8_ref",12,"041042",11,3,14,5
3010680,3022110,"B","5.9_ref",1,"041042",7,5,12,5
3038370,3050920,"A","5.10_ref",8,"041042",26,4,30,5
3078420,3087890,"B","5.11_ref",15,"041042",6,11,17,5
3105300,3113710,"A","5.12_ref",14,"041042",16,5,21,5
3136360,3148660,"B","5.13_ref",5,"041042",9,12,21,5
3170690,3177070,"A","5.14_ref",16,"041042",9,4,13,5
3211940,3228240,"B","5.15_ref",3,"041042",10,13,23,5
3241160,3250070,"A","5.16_ref",2,"041042",16,3,19,5
3265940,3273910,"B","6.1_ref",10,"041042",10,4,14,6
3281690,3290050,"A","6.2_ref",11,"041042",14,5,19,6
3306030,3317200,"B","6.3_ref",8,"041042",6,25,31,6
3330700,3341190,"A","6.4_ref",7,"041042",5,5,10,6
3362670,3368790,"B","6.5_ref",4,"041042",6,10,16,6
3381720,3396110,"A","6.6_ref",3,"041042",19,4,23,6
3411360,3418780,"B","6.7_ref",14,"041042",5,12,17,6
3434380,3439790,"A","6.8_ref",13,"041042",7,2,9,6
3454280,3463270,"B","6.9_ref",2,"041042",8,8,16,6
3477050,3485750,"A","6.10_ref",9,"041042",5,6,11,6
3498440,3504260,"B","6.11_ref",6,"041042",5,7,12,6
3520220,3532900,"A","6.12_ref",1,"041042",5,5,10,6
3550110,3560860,"B","6.13_ref",16,"041042",6,7,13,6
3570620,3578960,"A","6.14_ref",5,"041042",13,4,17,6
3590330,3598460,"B","6.15_ref",12,"041042",6,10,16,6
3613220,3622050,"A","6.16_ref",15,"041042",19,3,22,6
8160,49230,"B","1.1_ref",9,"043044",68,50,118,1
165320,177540,"A","1.2_ref",6,"043044",19,9,28,1
275860,302150,"B","1.3_ref",15,"043044",23,54,77,1
407710,422670,"A","1.4_ref",14,"043044",26,10,36,1
460820,473880,"B","1.5_ref",13,"043044",11,29,40,1
491690,508120,"A","1.6_ref",16,"043044",45,14,59,1
542400,562450,"B","1.7_ref",11,"043044",31,35,66,1
597790,640410,"A","1.8_ref",8,"043044",103,13,116,1
659560,675100,"B","1.9_ref",3,"043044",8,45,53,1
732780,762930,"A","1.10_ref",10,"043044",67,35,102,1
797070,816270,"B","1.11_ref",5,"043044",34,38,72,1
838210,869330,"A","1.12_ref",4,"043044",82,7,89,1
896010,917460,"B","1.13_ref",7,"043044",30,49,79,1
940160,971480,"A","1.14_ref",2,"043044",83,20,103,1
991880,1009390,"B","1.15_ref",1,"043044",17,43,60,1
1037770,1067600,"A","1.16_ref",12,"043044",77,24,101,1
1083540,1103260,"B","2.1_ref",14,"043044",29,29,58,2
1117830,1130600,"A","2.2_ref",9,"043044",36,2,38,2
1150430,1160620,"B","2.3_ref",16,"043044",5,15,20,2
1172930,1186800,"A","2.4_ref",3,"043044",30,12,42,2
1206670,1223780,"B","2.5_ref",10,"043044",24,28,52,2
1259450,1269410,"A","2.6_ref",11,"043044",16,9,25,2
1286670,1300670,"B","2.7_ref",12,"043044",25,26,51,2
1338030,1346950,"A","2.8_ref",7,"043044",23,3,26,2
1359270,1367450,"B","2.9_ref",6,"043044",11,10,21,2
1411360,1423050,"A","2.10_ref",13,"043044",33,9,42,2
1435580,1452160,"B","2.11_ref",2,"043044",13,52,65,2
1498490,1514600,"A","2.12_ref",15,"043044",31,12,43,2
1530560,1552410,"B","2.13_ref",8,"043044",31,50,81,2
1573440,1582270,"A","2.14_ref",1,"043044",19,1,20,2
1605010,1618450,"B","2.15_ref",4,"043044",5,32,37,2
1633300,1644240,"A","2.16_ref",5,"043044",27,9,36,2
1656830,1669190,"B","3.1_ref",9,"043044",7,23,30,3
1686100,1693460,"A","3.2_ref",10,"043044",10,7,17,3
1720470,1734360,"B","3.3_ref",15,"043044",20,27,47,3
1747970,1757210,"A","3.4_ref",12,"043044",25,3,28,3
1780410,1792080,"B","3.5_ref",1,"043044",7,31,38,3
1813340,1823650,"A","3.6_ref",4,"043044",15,14,29,3
1834560,1839070,"B","3.7_ref",7,"043044",4,11,15,3
1857140,1866390,"A","3.8_ref",16,"043044",10,13,23,3
1876880,1884040,"B","3.9_ref",13,"043044",5,17,22,3
1970520,1979520,"A","3.10_ref",2,"043044",23,2,25,3
1998440,2006880,"B","3.11_ref",11,"043044",5,18,23,3
2026860,2033690,"A","3.12_ref",6,"043044",8,5,13,3
2079010,2088650,"B","3.13_ref",5,"043044",7,7,14,3
2101040,2111780,"A","3.14_ref",8,"043044",28,2,30,3
2139440,2145010,"B","3.15_ref",3,"043044",4,3,7,3
2157480,2168210,"A","3.16_ref",14,"043044",24,1,25,3
2220570,2228200,"B","4.1_ref",10,"043044",9,16,25,4
2244510,2253750,"A","4.2_ref",15,"043044",15,6,21,4
2265200,2275230,"B","4.3_ref",6,"043044",8,9,17,4
2301610,2307500,"A","4.4_ref",1,"043044",10,2,12,4
2321370,2326500,"B","4.5_ref",16,"043044",4,7,11,4
2347110,2358870,"A","4.6_ref",13,"043044",23,5,28,4
2418300,2428130,"B","4.7_ref",12,"043044",17,8,25,4
2460600,2466470,"A","4.8_ref",7,"043044",12,2,14,4
2496970,2510520,"B","4.9_ref",2,"043044",8,21,29,4
2527980,2544000,"A","4.10_ref",9,"043044",11,15,26,4
2584420,2592930,"B","4.11_ref",14,"043044",10,21,31,4
2607180,2614050,"A","4.12_ref",5,"043044",11,3,14,4
2641620,2650170,"B","4.13_ref",8,"043044",5,19,24,4
2669600,2683660,"A","4.14_ref",11,"043044",31,13,44,4
2705580,2711280,"B","4.15_ref",4,"043044",6,6,12,4
2752270,2756970,"A","4.16_ref",3,"043044",3,3,6,4
2775310,2781890,"B","5.1_ref",7,"043044",8,11,19,5
2793000,2798170,"A","5.2_ref",6,"043044",6,3,9,5
2812460,2821190,"B","5.3_ref",11,"043044",9,10,19,5
2831740,2841400,"A","5.4_ref",10,"043044",11,3,14,5
2853200,2859100,"B","5.5_ref",9,"043044",6,7,13,5
2867050,2872560,"A","5.6_ref",4,"043044",5,4,9,5
2910230,2917840,"B","5.7_ref",13,"043044",7,11,18,5
2926670,2935550,"A","5.8_ref",12,"043044",26,6,32,5
2943620,2950810,"B","5.9_ref",1,"043044",4,16,20,5
2967870,2977580,"A","5.10_ref",8,"043044",27,3,30,5
3000270,3009670,"B","5.11_ref",15,"043044",6,19,25,5
3033590,3041580,"A","5.12_ref",14,"043044",15,2,17,5
3053890,3060650,"B","5.13_ref",5,"043044",9,5,14,5
3071570,3084550,"A","5.14_ref",16,"043044",22,14,36,5
3102970,3107130,"B","5.15_ref",3,"043044",5,2,7,5
3119810,3126550,"A","5.16_ref",2,"043044",16,2,18,5
3136410,3147950,"B","6.1_ref",10,"043044",12,15,27,6
3168180,3174080,"A","6.2_ref",11,"043044",16,3,19,6
3182170,3191200,"B","6.3_ref",8,"043044",5,15,20,6
3212760,3219640,"A","6.4_ref",7,"043044",13,3,16,6
3233740,3238040,"B","6.5_ref",4,"043044",4,4,8,6
3263820,3268830,"A","6.6_ref",3,"043044",2,3,5,6
3280140,3287750,"B","6.7_ref",14,"043044",2,13,15,6
3311020,3316760,"A","6.8_ref",13,"043044",15,2,17,6
3335190,3342670,"B","6.9_ref",2,"043044",7,12,19,6
3363270,3370770,"A","6.10_ref",9,"043044",13,2,15,6
3386340,3392010,"B","6.11_ref",6,"043044",4,7,11,6
3405660,3411840,"A","6.12_ref",1,"043044",9,2,11,6
3436450,3442120,"B","6.13_ref",16,"043044",8,4,12,6
3457810,3464350,"A","6.14_ref",5,"043044",7,3,10,6
3477380,3485690,"B","6.15_ref",12,"043044",10,4,14,6
3498930,3511010,"A","6.16_ref",15,"043044",23,4,27,6
3780,35220,"B","1.1_ref",9,"045046",21,26,47,1
62680,85930,"A","1.2_ref",6,"045046",31,14,45,1
92960,111710,"B","1.3_ref",15,"045046",8,28,36,1
123800,136840,"A","1.4_ref",14,"045046",25,5,30,1
149420,168340,"B","1.5_ref",13,"045046",20,33,53,1
193460,217030,"A","1.6_ref",16,"045046",54,9,63,1
235900,258650,"B","1.7_ref",11,"045046",29,38,67,1
284580,299230,"A","1.8_ref",8,"045046",39,4,43,1
316630,326960,"B","1.9_ref",3,"045046",17,15,32,1
339980,359600,"A","1.10_ref",10,"045046",50,5,55,1
376730,428170,"B","1.11_ref",5,"045046",72,93,165,1
436830,467970,"A","1.12_ref",4,"045046",73,19,92,1
498280,512530,"B","1.13_ref",7,"045046",36,19,55,1
524430,539030,"A","1.14_ref",2,"045046",38,6,44,1
548650,567950,"B","1.15_ref",1,"045046",13,39,52,1
579770,597680,"A","1.16_ref",12,"045046",47,8,55,1
610150,618850,"B","2.1_ref",14,"045046",6,18,24,2
626520,667080,"A","2.2_ref",9,"045046",107,32,139,2
687950,710590,"B","2.3_ref",16,"045046",38,32,70,2
717930,723380,"A","2.4_ref",3,"045046",8,1,9,2
737260,751940,"B","2.5_ref",10,"045046",13,31,44,2
760610,775710,"A","2.6_ref",11,"045046",39,6,45,2
790430,817080,"B","2.7_ref",12,"045046",29,39,68,2
829150,836430,"A","2.8_ref",7,"045046",12,3,15,2
844820,853640,"B","2.9_ref",6,"045046",9,5,14,2
867990,876780,"A","2.10_ref",13,"045046",22,6,28,2
885430,900070,"B","2.11_ref",2,"045046",16,23,39,2
914290,927350,"A","2.12_ref",15,"045046",31,7,38,2
934270,952060,"B","2.13_ref",8,"045046",23,35,58,2
967530,977360,"A","2.14_ref",1,"045046",28,6,34,2
984920,1000510,"B","2.15_ref",4,"045046",16,28,44,2
1010210,1021840,"A","2.16_ref",5,"045046",32,6,38,2
1036130,1050960,"B","3.1_ref",9,"045046",14,31,45,3
1057100,1068880,"A","3.2_ref",10,"045046",31,3,34,3
1078410,1086360,"B","3.3_ref",15,"045046",10,7,17,3
1092970,1107960,"A","3.4_ref",12,"045046",34,3,37,3
1115490,1124720,"B","3.5_ref",1,"045046",10,19,29,3
1133080,1143920,"A","3.6_ref",4,"045046",25,8,33,3
1154990,1162990,"B","3.7_ref",7,"045046",10,15,25,3
1167750,1183760,"A","3.8_ref",16,"045046",41,4,45,3
1191550,1199720,"B","3.9_ref",13,"045046",6,20,26,3
1207700,1233440,"A","3.10_ref",2,"045046",51,23,74,3
1245350,1254160,"B","3.11_ref",11,"045046",11,8,19,3
1265230,1270970,"A","3.12_ref",6,"045046",10,3,13,3
1299690,1311010,"B","3.13_ref",5,"045046",11,17,28,3
1317360,1331750,"A","3.14_ref",8,"045046",36,12,48,3
1347130,1352600,"B","3.15_ref",3,"045046",7,4,11,3
1359840,1367830,"A","3.16_ref",14,"045046",20,4,24,3
1407770,1420840,"B","4.1_ref",10,"045046",9,19,28,4
1436760,1443580,"A","4.2_ref",15,"045046",14,2,16,4
1447690,1453610,"B","4.3_ref",6,"045046",6,6,12,4
1469020,1479110,"A","4.4_ref",1,"045046",26,2,28,4
1488190,1502280,"B","4.5_ref",16,"045046",10,30,40,4
1516530,1525600,"A","4.6_ref",13,"045046",17,3,20,4
1540440,1548340,"B","4.7_ref",12,"045046",3,18,21,4
1555170,1562270,"A","4.8_ref",7,"045046",18,3,21,4
1571170,1581100,"B","4.9_ref",2,"045046",7,21,28,4
1588060,1605550,"A","4.10_ref",9,"045046",31,9,40,4
1618310,1627270,"B","4.11_ref",14,"045046",9,9,18,4
1638070,1650640,"A","4.12_ref",5,"045046",16,6,22,4
1661650,1672660,"B","4.13_ref",8,"045046",18,13,31,4
1681700,1687920,"A","4.14_ref",11,"045046",9,1,10,4
1695810,1704960,"B","4.15_ref",4,"045046",8,18,26,4
1716970,1724300,"A","4.16_ref",3,"045046",4,3,7,4
1729340,1737380,"B","5.1_ref",7,"045046",7,10,17,5
1745270,1751080,"A","5.2_ref",6,"045046",5,1,6,5
1764980,1770580,"B","5.3_ref",11,"045046",6,5,11,5
1782640,1794110,"A","5.4_ref",10,"045046",25,3,28,5
1805200,1819810,"B","5.5_ref",9,"045046",8,23,31,5
1828520,1836850,"A","5.6_ref",4,"045046",19,2,21,5
1854100,1861600,"B","5.7_ref",13,"045046",3,18,21,5
1870940,1878520,"A","5.8_ref",12,"045046",18,2,20,5
1883500,1895340,"B","5.9_ref",1,"045046",10,22,32,5
1915320,1932110,"A","5.10_ref",8,"045046",40,3,43,5
1938400,1946440,"B","5.11_ref",15,"045046",11,4,15,5
1957050,1970090,"A","5.12_ref",14,"045046",25,3,28,5
1976630,1986280,"B","5.13_ref",5,"045046",9,6,15,5
2001870,2018500,"A","5.14_ref",16,"045046",35,5,40,5
2031320,2036890,"B","5.15_ref",3,"045046",5,3,8,5
2043200,2050130,"A","5.16_ref",2,"045046",13,6,19,5
2054630,2080950,"B","6.1_ref",10,"045046",11,30,41,6
2100700,2106270,"A","6.2_ref",11,"045046",7,1,8,6
2116920,2125320,"B","6.3_ref",8,"045046",6,10,16,6
2131920,2138070,"A","6.4_ref",7,"045046",14,2,16,6
2155800,2166250,"B","6.5_ref",4,"045046",8,14,22,6
2173680,2179570,"A","6.6_ref",3,"045046",3,3,6,6
2189630,2196570,"B","6.7_ref",14,"045046",3,10,13,6
2201460,2208090,"A","6.8_ref",13,"045046",14,3,17,6
2217020,2226630,"B","6.9_ref",2,"045046",10,17,27,6
2233290,2243520,"A","6.10_ref",9,"045046",22,2,24,6
2253650,2257880,"B","6.11_ref",6,"045046",3,3,6,6
2268140,2275530,"A","6.12_ref",1,"045046",20,2,22,6
2283620,2305760,"B","6.13_ref",16,"045046",14,38,52,6
2313300,2320510,"A","6.14_ref",5,"045046",11,2,13,6
2323910,2331590,"B","6.15_ref",12,"045046",5,16,21,6
2338930,2346640,"A","6.16_ref",15,"045046",11,2,13,6
9030,42170,"B","1.1_ref",9,"047048",36,41,77,1
72440,89940,"A","1.2_ref",6,"047048",29,19,48,1
137970,162760,"B","1.3_ref",15,"047048",29,41,70,1
183070,204510,"A","1.4_ref",14,"047048",43,17,60,1
230120,252870,"B","1.5_ref",13,"047048",30,37,67,1
286850,307010,"A","1.6_ref",16,"047048",41,22,63,1
351190,377410,"B","1.7_ref",11,"047048",24,30,54,1
397720,419130,"A","1.8_ref",8,"047048",59,30,89,1
439880,447690,"B","1.9_ref",3,"047048",10,6,16,1
460010,478490,"A","1.10_ref",10,"047048",32,13,45,1
517320,550330,"B","1.11_ref",5,"047048",48,43,91,1
560080,587960,"A","1.12_ref",4,"047048",29,46,75,1
615870,631110,"B","1.13_ref",7,"047048",13,25,38,1
646530,655910,"A","1.14_ref",2,"047048",12,11,23,1
666780,680910,"B","1.15_ref",1,"047048",18,22,40,1
702610,724920,"A","1.16_ref",12,"047048",35,30,65,1
745550,775000,"B","2.1_ref",14,"047048",16,33,49,2
786000,794070,"A","2.2_ref",9,"047048",15,6,21,2
812750,831540,"B","2.3_ref",16,"047048",27,21,48,2
842890,848440,"A","2.4_ref",3,"047048",2,5,7,2
870270,884640,"B","2.5_ref",10,"047048",10,21,31,2
919320,932690,"A","2.6_ref",11,"047048",14,14,28,2
954750,972340,"B","2.7_ref",12,"047048",28,18,46,2
1001930,1010990,"A","2.8_ref",7,"047048",14,7,21,2
1021390,1035640,"B","2.9_ref",6,"047048",11,13,24,2
1068130,1083580,"A","2.10_ref",13,"047048",36,26,62,2
1094370,1122320,"B","2.11_ref",2,"047048",25,34,59,2
1134660,1148450,"A","2.12_ref",15,"047048",28,6,34,2
1160060,1182760,"B","2.13_ref",8,"047048",27,35,62,2
1193040,1199030,"A","2.14_ref",1,"047048",4,4,8,2
1209470,1223880,"B","2.15_ref",4,"047048",23,21,44,2
1243230,1254760,"A","2.16_ref",5,"047048",8,6,14,2
1265540,1272640,"B","3.1_ref",9,"047048",2,6,8,3
1285230,1300250,"A","3.2_ref",10,"047048",29,6,35,3
1309650,1325490,"B","3.3_ref",15,"047048",9,24,33,3
1335030,1341220,"A","3.4_ref",12,"047048",10,4,14,3
1350100,1355030,"B","3.5_ref",1,"047048",4,2,6,3
1368830,1374420,"A","3.6_ref",4,"047048",7,2,9,3
1386410,1393680,"B","3.7_ref",7,"047048",9,4,13,3
1403520,1408600,"A","3.8_ref",16,"047048",5,2,7,3
1422760,1433580,"B","3.9_ref",13,"047048",4,17,21,3
1475410,1486670,"A","3.10_ref",2,"047048",18,5,23,3
1496860,1519350,"B","3.11_ref",11,"047048",9,29,38,3
1537100,1557550,"A","3.12_ref",6,"047048",22,15,37,3
1570210,1582010,"B","3.13_ref",5,"047048",8,16,24,3
1589170,1609940,"A","3.14_ref",8,"047048",29,17,46,3
1622150,1628110,"B","3.15_ref",3,"047048",2,4,6,3
1640130,1646350,"A","3.16_ref",14,"047048",12,2,14,3
1666040,1687810,"B","4.1_ref",10,"047048",23,18,41,4
1705860,1716600,"A","4.2_ref",15,"047048",17,4,21,4
1729180,1734160,"B","4.3_ref",6,"047048",6,2,8,4
1751240,1754710,"A","4.4_ref",1,"047048",2,2,4,4
1766110,1779270,"B","4.5_ref",16,"047048",14,15,29,4
1791360,1798280,"A","4.6_ref",13,"047048",16,2,18,4
1812660,1823370,"B","4.7_ref",12,"047048",3,8,11,4
1837530,1846660,"A","4.8_ref",7,"047048",9,4,13,4
1855860,1863200,"B","4.9_ref",2,"047048",6,2,8,4
1881690,1886770,"A","4.10_ref",9,"047048",2,1,3,4
1899190,1906870,"B","4.11_ref",14,"047048",4,4,8,4
1933150,1939320,"A","4.12_ref",5,"047048",8,2,10,4
1948240,1962510,"B","4.13_ref",8,"047048",13,20,33,4
1979050,1997410,"A","4.14_ref",11,"047048",29,15,44,4
2006340,2015790,"B","4.15_ref",4,"047048",14,7,21,4
2030740,2034940,"A","4.16_ref",3,"047048",4,2,6,4
2046150,2052250,"B","5.1_ref",7,"047048",3,7,10,5
2068450,2073970,"A","5.2_ref",6,"047048",3,3,6,5
2083990,2094120,"B","5.3_ref",11,"047048",10,13,23,5
2116300,2124280,"A","5.4_ref",10,"047048",13,3,16,5
2132530,2140550,"B","5.5_ref",9,"047048",11,6,17,5
2158330,2164360,"A","5.6_ref",4,"047048",4,2,6,5
2178880,2186270,"B","5.7_ref",13,"047048",8,10,18,5
2196390,2202300,"A","5.8_ref",12,"047048",7,3,10,5
2214270,2218750,"B","5.9_ref",1,"047048",3,2,5,5
2236930,2244180,"A","5.10_ref",8,"047048",6,4,10,5
2254230,2262320,"B","5.11_ref",15,"047048",6,8,14,5
2272410,2278380,"A","5.12_ref",14,"047048",6,6,12,5
2289140,2302800,"B","5.13_ref",5,"047048",9,11,20,5
2308980,2314950,"A","5.14_ref",16,"047048",2,3,5,5
2321910,2327700,"B","5.15_ref",3,"047048",5,4,9,5
2333580,2338600,"A","5.16_ref",2,"047048",5,2,7,5
2346410,2362470,"B","6.1_ref",10,"047048",8,14,22,6
2376400,2384730,"A","6.2_ref",11,"047048",9,9,18,6
2392520,2398240,"B","6.3_ref",8,"047048",5,2,7,6
2407780,2415450,"A","6.4_ref",7,"047048",14,2,16,6
2433850,2438270,"B","6.5_ref",4,"047048",4,3,7,6
2445040,2450810,"A","6.6_ref",3,"047048",3,2,5,6
2460060,2465400,"B","6.7_ref",14,"047048",8,4,12,6
2475210,2481450,"A","6.8_ref",13,"047048",7,3,10,6
2509160,2514710,"B","6.9_ref",2,"047048",3,3,6,6
2532410,2536090,"A","6.10_ref",9,"047048",2,1,3,6
2545440,2550080,"B","6.11_ref",6,"047048",6,2,8,6
2556610,2562300,"A","6.12_ref",1,"047048",1,2,3,6
2571320,2578710,"B","6.13_ref",16,"047048",6,3,9,6
2588400,2595090,"A","6.14_ref",5,"047048",5,4,9,6
2603170,2610020,"B","6.15_ref",12,"047048",5,7,12,6
2618360,2627930,"A","6.16_ref",15,"047048",8,3,11,6
2090,50400,"B","1.1_ref",9,"049050",17,101,118,1
117520,138570,"A","1.2_ref",6,"049050",46,9,55,1
214780,251930,"B","1.3_ref",15,"049050",17,81,98,1
295260,315430,"A","1.4_ref",14,"049050",40,7,47,1
340110,368930,"B","1.5_ref",13,"049050",11,62,73,1
444000,474570,"A","1.6_ref",16,"049050",56,18,74,1
513860,540690,"B","1.7_ref",11,"049050",11,51,62,1
581120,606140,"A","1.8_ref",8,"049050",55,5,60,1
640340,674010,"B","1.9_ref",3,"049050",20,68,88,1
695930,728410,"A","1.10_ref",10,"049050",65,19,84,1
776180,822720,"B","1.11_ref",5,"049050",25,86,111,1
843790,862980,"A","1.12_ref",4,"049050",37,12,49,1
895730,918610,"B","1.13_ref",7,"049050",11,48,59,1
942990,969770,"A","1.14_ref",2,"049050",51,6,57,1
992820,1019070,"B","1.15_ref",1,"049050",8,57,65,1
1043190,1074830,"A","1.16_ref",12,"049050",46,19,65,1
1101360,1132920,"B","2.1_ref",14,"049050",18,53,71,2
1150400,1171870,"A","2.2_ref",9,"049050",50,3,53,2
1200320,1226350,"B","2.3_ref",16,"049050",8,46,54,2
1251790,1266730,"A","2.4_ref",3,"049050",29,7,36,2
1308180,1327350,"B","2.5_ref",10,"049050",8,36,44,2
1364090,1379570,"A","2.6_ref",11,"049050",30,6,36,2
1401760,1422280,"B","2.7_ref",12,"049050",4,40,44,2
1450540,1463770,"A","2.8_ref",7,"049050",27,4,31,2
1487580,1501420,"B","2.9_ref",6,"049050",6,30,36,2
1579070,1594750,"A","2.10_ref",13,"049050",32,6,38,2
1609440,1631820,"B","2.11_ref",2,"049050",7,42,49,2
1666290,1685850,"A","2.12_ref",15,"049050",42,11,53,2
1708500,1738580,"B","2.13_ref",8,"049050",16,60,76,2
1767770,1781440,"A","2.14_ref",1,"049050",26,2,28,2
1796760,1810420,"B","2.15_ref",4,"049050",17,12,29,2
1828210,1867900,"A","2.16_ref",5,"049050",56,23,79,2
1882450,1903730,"B","3.1_ref",9,"049050",5,41,46,3
1916790,1932340,"A","3.2_ref",10,"049050",36,5,41,3
1965830,1982470,"B","3.3_ref",15,"049050",8,37,45,3
1997440,2012140,"A","3.4_ref",12,"049050",32,5,37,3
2025050,2034390,"B","3.5_ref",1,"049050",10,8,18,3
2053070,2064950,"A","3.6_ref",4,"049050",18,4,22,3
2086020,2099760,"B","3.7_ref",7,"049050",14,17,31,3
2110860,2123030,"A","3.8_ref",16,"049050",30,4,34,3
2143970,2155760,"B","3.9_ref",13,"049050",3,23,26,3
2199480,2212700,"A","3.10_ref",2,"049050",29,4,33,3
2226990,2241040,"B","3.11_ref",11,"049050",6,43,49,3
2264700,2273980,"A","3.12_ref",6,"049050",24,8,32,3
2299130,2307250,"B","3.13_ref",5,"049050",6,12,18,3
2320540,2337680,"A","3.14_ref",8,"049050",40,6,46,3
2360370,2372480,"B","3.15_ref",3,"049050",5,23,28,3
2393890,2406630,"A","3.16_ref",14,"049050",24,3,27,3
2459590,2470790,"B","4.1_ref",10,"049050",8,22,30,4
2506180,2521930,"A","4.2_ref",15,"049050",32,6,38,4
2539370,2549220,"B","4.3_ref",6,"049050",7,18,25,4
2584380,2591440,"A","4.4_ref",1,"049050",13,6,19,4
2607810,2624570,"B","4.5_ref",16,"049050",9,34,43,4
2656600,2666630,"A","4.6_ref",13,"049050",21,3,24,4
2682300,2698940,"B","4.7_ref",12,"049050",9,37,46,4
2720080,2728970,"A","4.8_ref",7,"049050",17,5,22,4
2741500,2753330,"B","4.9_ref",2,"049050",5,27,32,4
2783180,2797470,"A","4.10_ref",9,"049050",23,10,33,4
2831610,2844880,"B","4.11_ref",14,"049050",8,24,32,4
2870960,2879590,"A","4.12_ref",5,"049050",12,6,18,4
2897840,2913680,"B","4.13_ref",8,"049050",6,38,44,4
2931770,2945220,"A","4.14_ref",11,"049050",27,3,30,4
2961600,2971660,"B","4.15_ref",4,"049050",5,14,19,4
2996820,3006570,"A","4.16_ref",3,"049050",16,4,20,4
3030700,3039150,"B","5.1_ref",7,"049050",4,17,21,5
3086710,3096990,"A","5.2_ref",6,"049050",14,9,23,5
3117110,3130600,"B","5.3_ref",11,"049050",8,40,48,5
3167600,3176740,"A","5.4_ref",10,"049050",19,3,22,5
3208070,3233630,"B","5.5_ref",9,"049050",14,43,57,5
3263800,3270530,"A","5.6_ref",4,"049050",13,7,20,5
3282890,3292530,"B","5.7_ref",13,"049050",6,18,24,5
3310100,3320900,"A","5.8_ref",12,"049050",22,5,27,5
3334400,3340920,"B","5.9_ref",1,"049050",7,6,13,5
3400300,3413150,"A","5.10_ref",8,"049050",25,5,30,5
3442180,3453690,"B","5.11_ref",15,"049050",7,20,27,5
3473110,3483300,"A","5.12_ref",14,"049050",21,4,25,5
3552680,3561710,"B","5.13_ref",5,"049050",7,7,14,5
3574410,3587980,"A","5.14_ref",16,"049050",32,4,36,5
3602370,3609890,"B","5.15_ref",3,"049050",0,0,0,5
3627290,3635550,"A","5.16_ref",2,"049050",0,0,0,5
3645990,3652630,"B","6.1_ref",10,"049050",0,0,0,6
3663650,3673810,"A","6.2_ref",11,"049050",0,0,0,6
3705130,3713990,"B","6.3_ref",8,"049050",0,0,0,6
3725360,3733380,"A","6.4_ref",7,"049050",0,0,0,6
3753090,3759370,"B","6.5_ref",4,"049050",0,0,0,6
3770620,3778820,"A","6.6_ref",3,"049050",0,0,0,6
3789740,3801500,"B","6.7_ref",14,"049050",0,0,0,6
3814890,3821200,"A","6.8_ref",13,"049050",0,0,0,6
3833970,3845610,"B","6.9_ref",2,"049050",0,0,0,6
3862760,3871210,"A","6.10_ref",9,"049050",0,0,0,6
3880780,3892380,"B","6.11_ref",6,"049050",0,0,0,6
3914730,3920170,"A","6.12_ref",1,"049050",0,0,0,6
3932310,3945850,"B","6.13_ref",16,"049050",0,0,0,6
3958620,3966630,"A","6.14_ref",5,"049050",0,0,0,6
3976320,3987840,"B","6.15_ref",12,"049050",0,0,0,6
4000790,4008000,"A","6.16_ref",15,"049050",0,0,0,6
5600,43290,"B","1.1_ref",9,"051052",35,60,95,1
72010,100060,"A","1.2_ref",6,"051052",63,16,79,1
130610,146440,"B","1.3_ref",15,"051052",12,34,46,1
173210,205120,"A","1.4_ref",14,"051052",84,23,107,1
222900,240140,"B","1.5_ref",13,"051052",23,22,45,1
266290,298460,"A","1.6_ref",16,"051052",80,16,96,1
309650,330250,"B","1.7_ref",11,"051052",7,51,58,1
376490,403320,"A","1.8_ref",8,"051052",57,21,78,1
427140,442270,"B","1.9_ref",3,"051052",16,28,44,1
475370,521230,"A","1.10_ref",10,"051052",104,53,157,1
543650,605850,"B","1.11_ref",5,"051052",79,105,184,1
619920,645600,"A","1.12_ref",4,"051052",66,10,76,1
666490,721060,"B","1.13_ref",7,"051052",48,103,151,1
733880,753650,"A","1.14_ref",2,"051052",46,7,53,1
766130,782820,"B","1.15_ref",1,"051052",16,43,59,1
804330,823220,"A","1.16_ref",12,"051052",40,13,53,1
842860,863680,"B","2.1_ref",14,"051052",18,33,51,2
873990,890010,"A","2.2_ref",9,"051052",34,17,51,2
915610,932580,"B","2.3_ref",16,"051052",10,41,51,2
941170,951140,"A","2.4_ref",3,"051052",19,7,26,2
978360,1000510,"B","2.5_ref",10,"051052",25,33,58,2
1013620,1029690,"A","2.6_ref",11,"051052",36,14,50,2
1041610,1067150,"B","2.7_ref",12,"051052",21,54,75,2
1079650,1097570,"A","2.8_ref",7,"051052",37,14,51,2
1113820,1126060,"B","2.9_ref",6,"051052",14,27,41,2
1158720,1168730,"A","2.10_ref",13,"051052",20,6,26,2
1176200,1190100,"B","2.11_ref",2,"051052",6,38,44,2
1200050,1218060,"A","2.12_ref",15,"051052",40,14,54,2
1246870,1286430,"B","2.13_ref",8,"051052",59,84,143,2
1298750,1309850,"A","2.14_ref",1,"051052",22,7,29,2
1323620,1342540,"B","2.15_ref",4,"051052",21,40,61,2
1356660,1370450,"A","2.16_ref",5,"051052",27,12,39,2
1385120,1398560,"B","3.1_ref",9,"051052",12,27,39,3
1407580,1432050,"A","3.2_ref",10,"051052",53,17,70,3
1471910,1486770,"B","3.3_ref",15,"051052",4,34,38,3
1493360,1502220,"A","3.4_ref",12,"051052",19,5,24,3
1518860,1529800,"B","3.5_ref",1,"051052",4,34,38,3
1549310,1560500,"A","3.6_ref",4,"051052",22,6,28,3
1573140,1601890,"B","3.7_ref",7,"051052",35,32,67,3
1608330,1622360,"A","3.8_ref",16,"051052",31,8,39,3
1658610,1667750,"B","3.9_ref",13,"051052",3,20,23,3
1693000,1702710,"A","3.10_ref",2,"051052",18,7,25,3
1723570,1741100,"B","3.11_ref",11,"051052",11,40,51,3
1749510,1754740,"A","3.12_ref",6,"051052",5,4,9,3
1778280,1796390,"B","3.13_ref",5,"051052",14,38,52,3
1802080,1815460,"A","3.14_ref",8,"051052",31,5,36,3
1855680,1868530,"B","3.15_ref",3,"051052",17,15,32,3
1888910,1898320,"A","3.16_ref",14,"051052",8,9,17,3
1925230,1947650,"B","4.1_ref",10,"051052",21,36,57,4
1982950,1994580,"A","4.2_ref",15,"051052",31,11,42,4
2003550,2009970,"B","4.3_ref",6,"051052",2,8,10,4
2078920,2094150,"A","4.4_ref",1,"051052",36,9,45,4
2101450,2113370,"B","4.5_ref",16,"051052",6,31,37,4
2124740,2133570,"A","4.6_ref",13,"051052",16,5,21,4
2165630,2175840,"B","4.7_ref",12,"051052",5,17,22,4
2190100,2205200,"A","4.8_ref",7,"051052",29,13,42,4
2218240,2228450,"B","4.9_ref",2,"051052",4,28,32,4
2248310,2260380,"A","4.10_ref",9,"051052",30,12,42,4
2272010,2282750,"B","4.11_ref",14,"051052",6,25,31,4
2299220,2311560,"A","4.12_ref",5,"051052",16,13,29,4
2329970,2344610,"B","4.13_ref",8,"051052",13,32,45,4
2354080,2363030,"A","4.14_ref",11,"051052",17,5,22,4
2382680,2393120,"B","4.15_ref",4,"051052",12,24,36,4
2406930,2414430,"A","4.16_ref",3,"051052",8,7,15,4
2418510,2426230,"B","5.1_ref",7,"051052",7,14,21,5
2436160,2443320,"A","5.2_ref",6,"051052",4,8,12,5
2475700,2485130,"B","5.3_ref",11,"051052",7,19,26,5
2516060,2526520,"A","5.4_ref",10,"051052",21,9,30,5
2549860,2564120,"B","5.5_ref",9,"051052",12,28,40,5
2580390,2588250,"A","5.6_ref",4,"051052",12,7,19,5
2601460,2610550,"B","5.7_ref",13,"051052",12,18,30,5
2621480,2628030,"A","5.8_ref",12,"051052",11,4,15,5
2639730,2651980,"B","5.9_ref",1,"051052",10,27,37,5
2663180,2674050,"A","5.10_ref",8,"051052",20,10,30,5
2682100,2694960,"B","5.11_ref",15,"051052",5,28,33,5
2711560,2728520,"A","5.12_ref",14,"051052",12,14,26,5
2741650,2762250,"B","5.13_ref",5,"051052",11,23,34,5
2774690,2790460,"A","5.14_ref",16,"051052",25,19,44,5
2807400,2812340,"B","5.15_ref",3,"051052",2,3,5,5
2825450,2834290,"A","5.16_ref",2,"051052",18,5,23,5
2837110,2847640,"B","6.1_ref",10,"051052",3,27,30,6
2866970,2874040,"A","6.2_ref",11,"051052",13,5,18,6
2896040,2906880,"B","6.3_ref",8,"051052",4,22,26,6
2918360,2928170,"A","6.4_ref",7,"051052",21,5,26,6
2942870,2950350,"B","6.5_ref",4,"051052",2,16,18,6
2964560,2969540,"A","6.6_ref",3,"051052",3,6,9,6
2993920,3000110,"B","6.7_ref",14,"051052",3,6,9,6
3007380,3013800,"A","6.8_ref",13,"051052",9,5,14,6
3033520,3046710,"B","6.9_ref",2,"051052",7,26,33,6
3068460,3092830,"A","6.10_ref",9,"051052",57,37,94,6
3103350,3109530,"B","6.11_ref",6,"051052",4,8,12,6
3126370,3134540,"A","6.12_ref",1,"051052",17,5,22,6
3144160,3153550,"B","6.13_ref",16,"051052",4,19,23,6
3160850,3172770,"A","6.14_ref",5,"051052",12,8,20,6
3179160,3190130,"B","6.15_ref",12,"051052",7,20,27,6
3199360,3209720,"A","6.16_ref",15,"051052",20,5,25,6
5250,41640,"B","1.1_ref",9,"053054",42,52,94,1
86560,109630,"A","1.2_ref",6,"053054",51,7,58,1
149620,178120,"B","1.3_ref",15,"053054",19,56,75,1
217080,240100,"A","1.4_ref",14,"053054",47,10,57,1
277050,301670,"B","1.5_ref",13,"053054",24,27,51,1
361500,402780,"A","1.6_ref",16,"053054",67,47,114,1
424570,444800,"B","1.7_ref",11,"053054",18,37,55,1
477840,507380,"A","1.8_ref",8,"053054",65,6,71,1
523020,538680,"B","1.9_ref",3,"053054",12,26,38,1
559410,585070,"A","1.10_ref",10,"053054",57,9,66,1
612090,633360,"B","1.11_ref",5,"053054",9,43,52,1
644400,669500,"A","1.12_ref",4,"053054",56,5,61,1
703830,726370,"B","1.13_ref",7,"053054",31,45,76,1
741110,787650,"A","1.14_ref",2,"053054",85,26,111,1
812960,837510,"B","1.15_ref",1,"053054",15,53,68,1
854420,879660,"A","1.16_ref",12,"053054",48,5,53,1
906020,928440,"B","2.1_ref",14,"053054",20,38,58,2
936780,961050,"A","2.2_ref",9,"053054",44,18,62,2
976010,992410,"B","2.3_ref",16,"053054",5,33,38,2
1013360,1025980,"A","2.4_ref",3,"053054",22,6,28,2
1042020,1053670,"B","2.5_ref",10,"053054",6,24,30,2
1067930,1085490,"A","2.6_ref",11,"053054",35,4,39,2
1115050,1134780,"B","2.7_ref",12,"053054",6,37,43,2
1175090,1187550,"A","2.8_ref",7,"053054",20,7,27,2
1200470,1213630,"B","2.9_ref",6,"053054",5,29,34,2
1244940,1275090,"A","2.10_ref",13,"053054",59,15,74,2
1284760,1315620,"B","2.11_ref",2,"053054",13,57,70,2
1329010,1355630,"A","2.12_ref",15,"053054",54,6,60,2
1366020,1381460,"B","2.13_ref",8,"053054",7,35,42,2
1395230,1412570,"A","2.14_ref",1,"053054",35,6,41,2
1440860,1475470,"B","2.15_ref",4,"053054",36,46,82,2
1494850,1516370,"A","2.16_ref",5,"053054",44,7,51,2
1532930,1555720,"B","3.1_ref",9,"053054",11,42,53,3
1576400,1596660,"A","3.2_ref",10,"053054",33,4,37,3
1644060,1658210,"B","3.3_ref",15,"053054",5,28,33,3
1680110,1700990,"A","3.4_ref",12,"053054",47,4,51,3
1712730,1724150,"B","3.5_ref",1,"053054",10,18,28,3
1747160,1769310,"A","3.6_ref",4,"053054",44,7,51,3
1781050,1790650,"B","3.7_ref",7,"053054",10,4,14,3
1798850,1815090,"A","3.8_ref",16,"053054",35,4,39,3
1853050,1863220,"B","3.9_ref",13,"053054",4,20,24,3
1880420,1900380,"A","3.10_ref",2,"053054",45,5,50,3
1921310,1935490,"B","3.11_ref",11,"053054",4,27,31,3
1982860,1999340,"A","3.12_ref",6,"053054",33,4,37,3
2018350,2032310,"B","3.13_ref",5,"053054",5,24,29,3
2042610,2068600,"A","3.14_ref",8,"053054",60,7,67,3
2086920,2094170,"B","3.15_ref",3,"053054",3,9,12,3
2104770,2122370,"A","3.16_ref",14,"053054",35,5,40,3
2151090,2158300,"B","4.1_ref",10,"053054",7,9,16,4
2187220,2210560,"A","4.2_ref",15,"053054",55,6,61,4
2222360,2237750,"B","4.3_ref",6,"053054",14,17,31,4
2255090,2266150,"A","4.4_ref",1,"053054",19,4,23,4
2278800,2292680,"B","4.5_ref",16,"053054",6,31,37,4
2309980,2323890,"A","4.6_ref",13,"053054",31,4,35,4
2339320,2362060,"B","4.7_ref",12,"053054",31,45,76,4
2373350,2380070,"A","4.8_ref",7,"053054",5,6,11,4
2396150,2410920,"B","4.9_ref",2,"053054",7,27,34,4
2428800,2447040,"A","4.10_ref",9,"053054",42,8,50,4
2466000,2495160,"B","4.11_ref",14,"053054",36,27,63,4
2520520,2532490,"A","4.12_ref",5,"053054",19,7,26,4
2566440,2576460,"B","4.13_ref",8,"053054",13,16,29,4
2588010,2604090,"A","4.14_ref",11,"053054",34,4,38,4
2621800,2632820,"B","4.15_ref",4,"053054",5,25,30,4
2644710,2654490,"A","4.16_ref",3,"053054",12,7,19,4
2659990,2665090,"B","5.1_ref",7,"053054",4,4,8,5
2686640,2700180,"A","5.2_ref",6,"053054",33,4,37,5
2723910,2768410,"B","5.3_ref",11,"053054",43,54,97,5
2786040,2795820,"A","5.4_ref",10,"053054",9,7,16,5
2816910,2830210,"B","5.5_ref",9,"053054",16,9,25,5
2838230,2851370,"A","5.6_ref",4,"053054",28,3,31,5
2860040,2866750,"B","5.7_ref",13,"053054",8,16,24,5
2883110,2894990,"A","5.8_ref",12,"053054",25,4,29,5
2910420,2918070,"B","5.9_ref",1,"053054",5,19,24,5
2940550,2956630,"A","5.10_ref",8,"053054",41,4,45,5
2965040,2974210,"B","5.11_ref",15,"053054",4,21,25,5
2989270,3001460,"A","5.12_ref",14,"053054",32,5,37,5
3018730,3029970,"B","5.13_ref",5,"053054",6,12,18,5
3036660,3052250,"A","5.14_ref",16,"053054",38,3,41,5
3070530,3079400,"B","5.15_ref",3,"053054",11,9,20,5
3088190,3105120,"A","5.16_ref",2,"053054",17,9,26,5
3110000,3116890,"B","6.1_ref",10,"053054",5,6,11,6
3131400,3143240,"A","6.2_ref",11,"053054",27,3,30,6
3155540,3163050,"B","6.3_ref",8,"053054",5,16,21,6
3172630,3178110,"A","6.4_ref",7,"053054",6,3,9,6
3188390,3195900,"B","6.5_ref",4,"053054",4,17,21,6
3208550,3215690,"A","6.6_ref",3,"053054",5,5,10,6
3226010,3236620,"B","6.7_ref",14,"053054",4,18,22,6
3248190,3254620,"A","6.8_ref",13,"053054",10,3,13,6
3268890,3276510,"B","6.9_ref",2,"053054",3,15,18,6
3294090,3304780,"A","6.10_ref",9,"053054",20,6,26,6
3330200,3343670,"B","6.11_ref",6,"053054",9,19,28,6
3366530,3374590,"A","6.12_ref",1,"053054",17,4,21,6
3389140,3396960,"B","6.13_ref",16,"053054",3,19,22,6
3403010,3413480,"A","6.14_ref",5,"053054",11,11,22,6
3419090,3430870,"B","6.15_ref",12,"053054",4,25,29,6
3439400,3446680,"A","6.16_ref",15,"053054",13,4,17,6
6600,57060,"B","1.1_ref",9,"055056",49,82,131,1
111250,146340,"A","1.2_ref",6,"055056",64,25,89,1
179230,228170,"B","1.3_ref",15,"055056",51,98,149,1
253860,290740,"A","1.4_ref",14,"055056",81,23,104,1
312780,344360,"B","1.5_ref",13,"055056",14,71,85,1
380180,427650,"A","1.6_ref",16,"055056",97,41,138,1
494710,532350,"B","1.7_ref",11,"055056",40,71,111,1
563150,668980,"A","1.8_ref",8,"055056",204,96,300,1
687960,724380,"B","1.9_ref",3,"055056",45,67,112,1
742420,827260,"A","1.10_ref",10,"055056",158,72,230,1
847730,926580,"B","1.11_ref",5,"055056",85,144,229,1
943180,975910,"A","1.12_ref",4,"055056",66,30,96,1
1013200,1085940,"B","1.13_ref",7,"055056",70,147,217,1
1108050,1140070,"A","1.14_ref",2,"055056",67,12,79,1
1164000,1198670,"B","1.15_ref",1,"055056",19,74,93,1
1213080,1252090,"A","1.16_ref",12,"055056",81,27,108,1
1288920,1324010,"B","2.1_ref",14,"055056",31,71,102,2
1341070,1355740,"A","2.2_ref",9,"055056",17,8,25,2
1387500,1429790,"B","2.3_ref",16,"055056",15,90,105,2
1441930,1450100,"A","2.4_ref",3,"055056",6,10,16,2
1466640,1488090,"B","2.5_ref",10,"055056",10,40,50,2
1513700,1534420,"A","2.6_ref",11,"055056",46,11,57,2
1560120,1577090,"B","2.7_ref",12,"055056",6,34,40,2
1655280,1690920,"A","2.8_ref",7,"055056",36,42,78,2
1718920,1735900,"B","2.9_ref",6,"055056",14,25,39,2
1769570,1789060,"A","2.10_ref",13,"055056",36,13,49,2
1798870,1828400,"B","2.11_ref",2,"055056",7,64,71,2
1859330,1877650,"A","2.12_ref",15,"055056",34,6,40,2
1892240,1919120,"B","2.13_ref",8,"055056",33,59,92,2
1938960,1964540,"A","2.14_ref",1,"055056",45,10,55,2
1977170,1986470,"B","2.15_ref",4,"055056",15,16,31,2
2015370,2028470,"A","2.16_ref",5,"055056",21,13,34,2
2039460,2057540,"B","3.1_ref",9,"055056",27,22,49,3
2072970,2082490,"A","3.2_ref",10,"055056",7,8,15,3
2131570,2144400,"B","3.3_ref",15,"055056",16,24,40,3
2160160,2173390,"A","3.4_ref",12,"055056",20,9,29,3
2207460,2223880,"B","3.5_ref",1,"055056",18,28,46,3
2254270,2262650,"A","3.6_ref",4,"055056",4,11,15,3
2321230,2336830,"B","3.7_ref",7,"055056",11,26,37,3
2352990,2376340,"A","3.8_ref",16,"055056",47,9,56,3
2404500,2422050,"B","3.9_ref",13,"055056",24,30,54,3
2516700,2526580,"A","3.10_ref",2,"055056",12,14,26,3
2549880,2569810,"B","3.11_ref",11,"055056",29,33,62,3
2583330,2594960,"A","3.12_ref",6,"055056",17,9,26,3
2608110,2617010,"B","3.13_ref",5,"055056",9,7,16,3
2637150,2653870,"A","3.14_ref",8,"055056",27,9,36,3
2677410,2683560,"B","3.15_ref",3,"055056",11,3,14,3
2697730,2712990,"A","3.16_ref",14,"055056",21,12,33,3
2728230,2737170,"B","4.1_ref",10,"055056",15,10,25,4
2777050,2792000,"A","4.2_ref",15,"055056",30,10,40,4
2836050,2845730,"B","4.3_ref",6,"055056",13,11,24,4
2885810,2893520,"A","4.4_ref",1,"055056",10,7,17,4
2919580,2945040,"B","4.5_ref",16,"055056",15,51,66,4
2957590,2962360,"A","4.6_ref",13,"055056",7,5,12,4
2985400,2997290,"B","4.7_ref",12,"055056",17,7,24,4
3016750,3033990,"A","4.8_ref",7,"055056",17,6,23,4
3048760,3057910,"B","4.9_ref",2,"055056",4,13,17,4
3070540,3081190,"A","4.10_ref",9,"055056",15,15,30,4
3134950,3146640,"B","4.11_ref",14,"055056",10,25,35,4
3219540,3227690,"A","4.12_ref",5,"055056",6,9,15,4
3278810,3296500,"B","4.13_ref",8,"055056",21,36,57,4
3315140,3325920,"A","4.14_ref",11,"055056",18,7,25,4
3350250,3359650,"B","4.15_ref",4,"055056",7,4,11,4
3409400,3415570,"A","4.16_ref",3,"055056",5,7,12,4
3426700,3443620,"B","5.1_ref",7,"055056",25,35,60,5
3479300,3489730,"A","5.2_ref",6,"055056",17,7,24,5
3540580,3556600,"B","5.3_ref",11,"055056",11,27,38,5
3582820,3590730,"A","5.4_ref",10,"055056",3,10,13,5
3619370,3628740,"B","5.5_ref",9,"055056",9,11,20,5
3643130,3650760,"A","5.6_ref",4,"055056",4,10,14,5
3681870,3688880,"B","5.7_ref",13,"055056",8,6,14,5
3767930,3779050,"A","5.8_ref",12,"055056",4,8,12,5
3798120,3808780,"B","5.9_ref",1,"055056",7,14,21,5
3823190,3831500,"A","5.10_ref",8,"055056",18,5,23,5
3849170,3860250,"B","5.11_ref",15,"055056",8,21,29,5
3898050,3908410,"A","5.12_ref",14,"055056",17,10,27,5
3969110,3976760,"B","5.13_ref",5,"055056",5,3,8,5
4007710,4027820,"A","5.14_ref",16,"055056",19,10,29,5
4055440,4061000,"B","5.15_ref",3,"055056",7,3,10,5
4074550,4085440,"A","5.16_ref",2,"055056",6,17,23,5
4092990,4106470,"B","6.1_ref",10,"055056",12,4,16,6
4128010,4157740,"A","6.2_ref",11,"055056",56,29,85,6
4172190,4185880,"B","6.3_ref",8,"055056",8,22,30,6
4199830,4210520,"A","6.4_ref",7,"055056",18,7,25,6
4232770,4240640,"B","6.5_ref",4,"055056",9,4,13,6
4264770,4272660,"A","6.6_ref",3,"055056",5,11,16,6
4285100,4297750,"B","6.7_ref",14,"055056",9,24,33,6
4309980,4315430,"A","6.8_ref",13,"055056",4,6,10,6
4325470,4331310,"B","6.9_ref",2,"055056",5,8,13,6
4362580,4371960,"A","6.10_ref",9,"055056",4,9,13,6
4404500,4414670,"B","6.11_ref",6,"055056",14,9,23,6
4448610,4455600,"A","6.12_ref",1,"055056",4,6,10,6
4472160,4484500,"B","6.13_ref",16,"055056",8,22,30,6
4499770,4507790,"A","6.14_ref",5,"055056",10,13,23,6
4526700,4535160,"B","6.15_ref",12,"055056",4,5,9,6
4562290,4571810,"A","6.16_ref",15,"055056",15,9,24,6
2520,59030,"B","1.1_ref",9,"057058",82,118,200,1
92110,110790,"A","1.2_ref",6,"057058",49,40,89,1
140340,151200,"B","1.3_ref",15,"057058",14,19,33,1
171980,186230,"A","1.4_ref",14,"057058",36,23,59,1
202510,213070,"B","1.5_ref",13,"057058",18,24,42,1
239320,293180,"A","1.6_ref",16,"057058",136,49,185,1
308850,323850,"B","1.7_ref",11,"057058",21,36,57,1
336770,358800,"A","1.8_ref",8,"057058",66,22,88,1
385460,395510,"B","1.9_ref",3,"057058",11,26,37,1
405900,426900,"A","1.10_ref",10,"057058",60,38,98,1
435150,471800,"B","1.11_ref",5,"057058",61,66,127,1
482890,503880,"A","1.12_ref",4,"057058",56,27,83,1
520440,536410,"B","1.13_ref",7,"057058",24,37,61,1
547100,563570,"A","1.14_ref",2,"057058",43,20,63,1
573600,589090,"B","1.15_ref",1,"057058",29,35,64,1
598010,623280,"A","1.16_ref",12,"057058",65,29,94,1
632730,641530,"B","2.1_ref",14,"057058",14,14,28,2
647160,666550,"A","2.2_ref",9,"057058",48,13,61,2
682260,696620,"B","2.3_ref",16,"057058",25,32,57,2
716260,723960,"A","2.4_ref",3,"057058",19,8,27,2
744920,751780,"B","2.5_ref",10,"057058",11,15,26,2
767820,779090,"A","2.6_ref",11,"057058",30,8,38,2
788540,797130,"B","2.7_ref",12,"057058",11,20,31,2
818240,828860,"A","2.8_ref",7,"057058",25,7,32,2
840900,850150,"B","2.9_ref",6,"057058",21,18,39,2
868810,879380,"A","2.10_ref",13,"057058",24,11,35,2
889150,901840,"B","2.11_ref",2,"057058",23,26,49,2
919770,934580,"A","2.12_ref",15,"057058",45,27,72,2
943810,963830,"B","2.13_ref",8,"057058",24,53,77,2
974030,988320,"A","2.14_ref",1,"057058",40,11,51,2
1023220,1031060,"B","2.15_ref",4,"057058",15,21,36,2
1041330,1075120,"A","2.16_ref",5,"057058",83,35,118,2
1092840,1130860,"B","3.1_ref",9,"057058",37,76,113,3
1137380,1150750,"A","3.2_ref",10,"057058",36,19,55,3
1164550,1171620,"B","3.3_ref",15,"057058",13,17,30,3
1177180,1186210,"A","3.4_ref",12,"057058",24,7,31,3
1201790,1209900,"B","3.5_ref",1,"057058",13,17,30,3
1222100,1231840,"A","3.6_ref",4,"057058",24,8,32,3
1244930,1255330,"B","3.7_ref",7,"057058",11,22,33,3
1263030,1282380,"A","3.8_ref",16,"057058",54,21,75,3
1292120,1300660,"B","3.9_ref",13,"057058",8,18,26,3
1310810,1322220,"A","3.10_ref",2,"057058",35,10,45,3
1333860,1345760,"B","3.11_ref",11,"057058",11,26,37,3
1358900,1366980,"A","3.12_ref",6,"057058",18,18,36,3
1377790,1387380,"B","3.13_ref",5,"057058",11,21,32,3
1399110,1409600,"A","3.14_ref",8,"057058",26,12,38,3
1421300,1428420,"B","3.15_ref",3,"057058",9,14,23,3
1434330,1444840,"A","3.16_ref",14,"057058",20,16,36,3
1477550,1483530,"B","4.1_ref",10,"057058",11,7,18,4
1494830,1503930,"A","4.2_ref",15,"057058",26,9,35,4
1511840,1518940,"B","4.3_ref",6,"057058",6,11,17,4
1529800,1537840,"A","4.4_ref",1,"057058",24,9,33,4
1550460,1559960,"B","4.5_ref",16,"057058",9,24,33,4
1584410,1594110,"A","4.6_ref",13,"057058",23,5,28,4
1621370,1625230,"B","4.7_ref",12,"057058",6,9,15,4
1639530,1674860,"A","4.8_ref",7,"057058",96,46,142,4
1684770,1693380,"B","4.9_ref",2,"057058",4,13,17,4
1705610,1719130,"A","4.10_ref",9,"057058",32,8,40,4
1729780,1739410,"B","4.11_ref",14,"057058",7,16,23,4
1756860,1790000,"A","4.12_ref",5,"057058",75,51,126,4
1799530,1807200,"B","4.13_ref",8,"057058",3,9,12,4
1820710,1831570,"A","4.14_ref",11,"057058",23,7,30,4
1853600,1858690,"B","4.15_ref",4,"057058",6,6,12,4
1877360,1881530,"A","4.16_ref",3,"057058",8,7,15,4
1903960,1909520,"B","5.1_ref",7,"057058",7,11,18,5
1926090,1932900,"A","5.2_ref",6,"057058",18,9,27,5
1939960,1947150,"B","5.3_ref",11,"057058",5,12,17,5
1963620,1968590,"A","5.4_ref",10,"057058",10,5,15,5
1996100,2004620,"B","5.5_ref",9,"057058",13,22,35,5
2021510,2027940,"A","5.6_ref",4,"057058",15,8,23,5
2043530,2048840,"B","5.7_ref",13,"057058",9,12,21,5
2056270,2063410,"A","5.8_ref",12,"057058",17,5,22,5
2079070,2091300,"B","5.9_ref",1,"057058",11,21,32,5
2109260,2118040,"A","5.10_ref",8,"057058",26,12,38,5
2127690,2136610,"B","5.11_ref",15,"057058",13,19,32,5
2171820,2179630,"A","5.12_ref",14,"057058",18,10,28,5
2189230,2203660,"B","5.13_ref",5,"057058",19,27,46,5
2226870,2238940,"A","5.14_ref",16,"057058",32,18,50,5
2257490,2261420,"B","5.15_ref",3,"057058",3,8,11,5
2269640,2283890,"A","5.16_ref",2,"057058",42,22,64,5
2297310,2304320,"B","6.1_ref",10,"057058",3,5,8,6
2313160,2324840,"A","6.2_ref",11,"057058",21,13,34,6
2340190,2346790,"B","6.3_ref",8,"057058",5,6,11,6
2356110,2362690,"A","6.4_ref",7,"057058",11,5,16,6
2385410,2390000,"B","6.5_ref",4,"057058",4,6,10,6
2398640,2403090,"A","6.6_ref",3,"057058",7,3,10,6
2413120,2420380,"B","6.7_ref",14,"057058",2,9,11,6
2434090,2440950,"A","6.8_ref",13,"057058",16,5,21,6
2452670,2458060,"B","6.9_ref",2,"057058",4,9,13,6
2490740,2503110,"A","6.10_ref",9,"057058",28,6,34,6
2530150,2533560,"B","6.11_ref",6,"057058",5,8,13,6
2542870,2550560,"A","6.12_ref",1,"057058",17,4,21,6
2563670,2575660,"B","6.13_ref",16,"057058",20,28,48,6
2586950,2594660,"A","6.14_ref",5,"057058",13,9,22,6
2612320,2617990,"B","6.15_ref",12,"057058",4,6,10,6
2627420,2633510,"A","6.16_ref",15,"057058",14,4,18,6
4120,34150,"B","1.1_ref",9,"063064",22,58,80,1
74340,120450,"A","1.2_ref",6,"063064",78,44,122,1
173030,195230,"B","1.3_ref",15,"063064",12,40,52,1
219690,243970,"A","1.4_ref",14,"063064",46,21,67,1
255930,282620,"B","1.5_ref",13,"063064",18,59,77,1
333540,371870,"A","1.6_ref",16,"063064",86,12,98,1
419370,445390,"B","1.7_ref",11,"063064",14,51,65,1
462100,495490,"A","1.8_ref",8,"063064",73,7,80,1
513750,533840,"B","1.9_ref",3,"063064",6,47,53,1
552000,586940,"A","1.10_ref",10,"063064",70,8,78,1
597750,630550,"B","1.11_ref",5,"063064",30,74,104,1
643670,663000,"A","1.12_ref",4,"063064",38,26,64,1
677220,696890,"B","1.13_ref",7,"063064",11,40,51,1
712450,740880,"A","1.14_ref",2,"063064",64,6,70,1
753230,774020,"B","1.15_ref",1,"063064",7,47,54,1
791250,819850,"A","1.16_ref",12,"063064",66,12,78,1
833180,858930,"B","2.1_ref",14,"063064",11,48,59,2
878310,890840,"A","2.2_ref",9,"063064",27,11,38,2
909860,922380,"B","2.3_ref",16,"063064",9,18,27,2
931530,944460,"A","2.4_ref",3,"063064",32,4,36,2
956480,976060,"B","2.5_ref",10,"063064",7,49,56,2
991170,1008880,"A","2.6_ref",11,"063064",41,4,45,2
1018230,1033990,"B","2.7_ref",12,"063064",8,36,44,2
1083580,1102040,"A","2.8_ref",7,"063064",46,6,52,2
1109360,1122450,"B","2.9_ref",6,"063064",4,29,33,2
1135720,1147980,"A","2.10_ref",13,"063064",25,6,31,2
1155040,1174460,"B","2.11_ref",2,"063064",6,45,51,2
1189370,1206430,"A","2.12_ref",15,"063064",38,4,42,2
1222930,1241200,"B","2.13_ref",8,"063064",11,40,51,2
1263010,1275190,"A","2.14_ref",1,"063064",32,4,36,2
1285200,1294460,"B","2.15_ref",4,"063064",10,10,20,2
1311250,1326520,"A","2.16_ref",5,"063064",16,7,23,2
1341520,1358250,"B","3.1_ref",9,"063064",8,32,40,3
1371860,1383870,"A","3.2_ref",10,"063064",23,4,27,3
1404350,1418230,"B","3.3_ref",15,"063064",8,32,40,3
1443670,1455130,"A","3.4_ref",12,"063064",28,6,34,3
1464570,1476000,"B","3.5_ref",1,"063064",8,30,38,3
1492490,1500130,"A","3.6_ref",4,"063064",9,4,13,3
1516870,1530290,"B","3.7_ref",7,"063064",3,34,37,3
1543270,1562570,"A","3.8_ref",16,"063064",8,15,23,3
1585090,1591660,"B","3.9_ref",13,"063064",3,7,10,3
1611450,1621710,"A","3.10_ref",2,"063064",13,4,17,3
1640880,1655900,"B","3.11_ref",11,"063064",4,34,38,3
1670230,1685430,"A","3.12_ref",6,"063064",22,11,33,3
1710980,1719390,"B","3.13_ref",5,"063064",3,10,13,3
1734220,1759270,"A","3.14_ref",8,"063064",49,13,62,3
1778290,1788090,"B","3.15_ref",3,"063064",6,18,24,3
1796190,1806010,"A","3.16_ref",14,"063064",23,4,27,3
1819860,1842340,"B","4.1_ref",10,"063064",17,42,59,4
1854670,1866030,"A","4.2_ref",15,"063064",18,11,29,4
1878660,1894510,"B","4.3_ref",6,"063064",5,28,33,4
1935410,1947120,"A","4.4_ref",1,"063064",25,3,28,4
1959320,1966600,"B","4.5_ref",16,"063064",2,8,10,4
1982660,1988300,"A","4.6_ref",13,"063064",7,5,12,4
1999130,2009610,"B","4.7_ref",12,"063064",2,25,27,4
2024980,2040610,"A","4.8_ref",7,"063064",31,6,37,4
2051440,2065660,"B","4.9_ref",2,"063064",4,30,34,4
2091290,2102520,"A","4.10_ref",9,"063064",20,4,24,4
2126060,2139420,"B","4.11_ref",14,"063064",2,30,32,4
2161180,2168210,"A","4.12_ref",5,"063064",9,5,14,4
2209660,2221040,"B","4.13_ref",8,"063064",2,30,32,4
2237850,2251050,"A","4.14_ref",11,"063064",26,4,30,4
2261070,2268620,"B","4.15_ref",4,"063064",4,6,10,4
2291340,2298190,"A","4.16_ref",3,"063064",9,4,13,4
2304290,2313870,"B","5.1_ref",7,"063064",1,21,22,5
2335600,2347490,"A","5.2_ref",6,"063064",26,5,31,5
2356880,2373780,"B","5.3_ref",11,"063064",2,29,31,5
2396280,2404810,"A","5.4_ref",10,"063064",3,5,8,5
2433830,2448160,"B","5.5_ref",9,"063064",6,33,39,5
2486580,2493270,"A","5.6_ref",4,"063064",4,4,8,5
2513550,2519120,"B","5.7_ref",13,"063064",3,7,10,5
2536430,2546180,"A","5.8_ref",12,"063064",15,5,20,5
2557000,2576120,"B","5.9_ref",1,"063064",7,39,46,5
2593860,2607540,"A","5.10_ref",8,"063064",28,5,33,5
2623390,2634180,"B","5.11_ref",15,"063064",3,26,29,5
2656810,2667100,"A","5.12_ref",14,"063064",24,6,30,5
2676480,2683830,"B","5.13_ref",5,"063064",6,8,14,5
2694440,2704530,"A","5.14_ref",16,"063064",4,4,8,5
2728810,2737490,"B","5.15_ref",3,"063064",3,7,10,5
2763370,2773010,"A","5.16_ref",2,"063064",9,7,16,5
2778370,2787440,"B","6.1_ref",10,"063064",3,5,8,6
2801700,2828660,"A","6.2_ref",11,"063064",55,14,69,6
2844310,2860320,"B","6.3_ref",8,"063064",7,32,39,6
2882470,2896870,"A","6.4_ref",7,"063064",28,3,31,6
2912860,2920730,"B","6.5_ref",4,"063064",4,5,9,6
2947060,2954960,"A","6.6_ref",3,"063064",6,7,13,6
2968920,2978890,"B","6.7_ref",14,"063064",3,21,24,6
2990880,2996660,"A","6.8_ref",13,"063064",6,4,10,6
3010860,3019380,"B","6.9_ref",2,"063064",1,14,15,6
3030540,3038180,"A","6.10_ref",9,"063064",12,3,15,6
3057200,3066730,"B","6.11_ref",6,"063064",2,22,24,6
3094880,3105320,"A","6.12_ref",1,"063064",27,3,30,6
3115290,3123830,"B","6.13_ref",16,"063064",4,6,10,6
3134400,3140300,"A","6.14_ref",5,"063064",7,2,9,6
3146810,3158580,"B","6.15_ref",12,"063064",2,27,29,6
3172550,3181370,"A","6.16_ref",15,"063064",9,4,13,6
51590,113280,"B","1.1_ref",9,"065066",91,38,129,1
140210,163260,"A","1.2_ref",6,"065066",24,30,54,1
186270,203040,"B","1.3_ref",15,"065066",26,25,51,1
216090,229370,"A","1.4_ref",14,"065066",19,12,31,1
331400,345840,"B","1.5_ref",13,"065066",18,34,52,1
357470,378010,"A","1.6_ref",16,"065066",45,34,79,1
397680,420010,"B","1.7_ref",11,"065066",30,51,81,1
434580,465260,"A","1.8_ref",8,"065066",50,37,87,1
488330,498080,"B","1.9_ref",3,"065066",8,21,29,1
503170,561950,"A","1.10_ref",10,"065066",96,54,150,1
576950,591100,"B","1.11_ref",5,"065066",13,34,47,1
607050,645720,"A","1.12_ref",4,"065066",76,27,103,1
654210,665520,"B","1.13_ref",7,"065066",13,29,42,1
670820,685570,"A","1.14_ref",2,"065066",32,3,35,1
690240,720610,"B","1.15_ref",1,"065066",31,73,104,1
726560,763870,"A","1.16_ref",12,"065066",80,27,107,1
775230,785800,"B","2.1_ref",14,"065066",8,26,34,2
790050,802600,"A","2.2_ref",9,"065066",26,10,36,2
816310,847010,"B","2.3_ref",16,"065066",30,69,99,2
855180,863710,"A","2.4_ref",3,"065066",10,11,21,2
870560,884140,"B","2.5_ref",10,"065066",13,31,44,2
895050,903690,"A","2.6_ref",11,"065066",19,4,23,2
911260,920520,"B","2.7_ref",12,"065066",8,15,23,2
930660,937590,"A","2.8_ref",7,"065066",14,10,24,2
947850,956410,"B","2.9_ref",6,"065066",8,11,19,2
962390,975930,"A","2.10_ref",13,"065066",28,18,46,2
982350,991800,"B","2.11_ref",2,"065066",8,15,23,2
996940,1005400,"A","2.12_ref",15,"065066",10,5,15,2
1009830,1022210,"B","2.13_ref",8,"065066",9,32,41,2
1026690,1033340,"A","2.14_ref",1,"065066",5,2,7,2
1050940,1063830,"B","2.15_ref",4,"065066",15,21,36,2
1071700,1089760,"A","2.16_ref",5,"065066",30,23,53,2
1101330,1112200,"B","3.1_ref",9,"065066",5,31,36,3
1116750,1125280,"A","3.2_ref",10,"065066",5,8,13,3
1146690,1153030,"B","3.3_ref",15,"065066",5,5,10,3
1157230,1164480,"A","3.4_ref",12,"065066",6,2,8,3
1185360,1202600,"B","3.5_ref",1,"065066",14,37,51,3
1208650,1226310,"A","3.6_ref",4,"065066",30,31,61,3
1234210,1241690,"B","3.7_ref",7,"065066",3,17,20,3
1249430,1256010,"A","3.8_ref",16,"065066",13,5,18,3
1267680,1273780,"B","3.9_ref",13,"065066",6,8,14,3
1291320,1297440,"A","3.10_ref",2,"065066",16,2,18,3
1311770,1318370,"B","3.11_ref",11,"065066",6,20,26,3
1324740,1329350,"A","3.12_ref",6,"065066",5,1,6,3
1346940,1358030,"B","3.13_ref",5,"065066",4,23,27,3
1363540,1372820,"A","3.14_ref",8,"065066",4,7,11,3
1396130,1401390,"B","3.15_ref",3,"065066",3,12,15,3
1428890,1439090,"A","3.16_ref",14,"065066",10,7,17,3
1466000,1478500,"B","4.1_ref",10,"065066",11,9,20,4
1491680,1499400,"A","4.2_ref",15,"065066",6,6,12,4
1509550,1514510,"B","4.3_ref",6,"065066",2,4,6,4
1523350,1529400,"A","4.4_ref",1,"065066",3,2,5,4
1533880,1546300,"B","4.5_ref",16,"065066",12,15,27,4
1552590,1557170,"A","4.6_ref",13,"065066",6,1,7,4
1576270,1582180,"B","4.7_ref",12,"065066",6,17,23,4
1600210,1605810,"A","4.8_ref",7,"065066",10,4,14,4
1615940,1623400,"B","4.9_ref",2,"065066",6,16,22,4
1627550,1637060,"A","4.10_ref",9,"065066",21,7,28,4
1644320,1650300,"B","4.11_ref",14,"065066",3,8,11,4
1658260,1671860,"A","4.12_ref",5,"065066",11,5,16,4
1683850,1690190,"B","4.13_ref",8,"065066",3,12,15,4
1696310,1704200,"A","4.14_ref",11,"065066",15,2,17,4
1713440,1724580,"B","4.15_ref",4,"065066",11,20,31,4
1731110,1737280,"A","4.16_ref",3,"065066",10,2,12,4
1744840,1752650,"B","5.1_ref",7,"065066",4,10,14,5
1757400,1763460,"A","5.2_ref",6,"065066",5,2,7,5
1778470,1786270,"B","5.3_ref",11,"065066",3,18,21,5
1805740,1811250,"A","5.4_ref",10,"065066",6,5,11,5
1827620,1835040,"B","5.5_ref",9,"065066",4,18,22,5
1841450,1848010,"A","5.6_ref",4,"065066",10,2,12,5
1854880,1860940,"B","5.7_ref",13,"065066",6,13,19,5
1865350,1870360,"A","5.8_ref",12,"065066",4,1,5,5
1880610,1892460,"B","5.9_ref",1,"065066",7,11,18,5
1907500,1913910,"A","5.10_ref",8,"065066",5,3,8,5
1924970,1930490,"B","5.11_ref",15,"065066",4,5,9,5
1939740,1944900,"A","5.12_ref",14,"065066",4,4,8,5
1954980,1962750,"B","5.13_ref",5,"065066",5,15,20,5
1969570,1978820,"A","5.14_ref",16,"065066",4,3,7,5
1991940,2000820,"B","5.15_ref",3,"065066",8,7,15,5
2010040,2017280,"A","5.16_ref",2,"065066",9,2,11,5
2020700,2027960,"B","6.1_ref",10,"065066",6,3,9,6
2036780,2043630,"A","6.2_ref",11,"065066",13,3,16,6
2053760,2059760,"B","6.3_ref",8,"065066",3,3,6,6
2069020,2073980,"A","6.4_ref",7,"065066",4,2,6,6
2083080,2091580,"B","6.5_ref",4,"065066",11,20,31,6
2098350,2106330,"A","6.6_ref",3,"065066",5,3,8,6
2111480,2119960,"B","6.7_ref",14,"065066",10,14,24,6
2126960,2131490,"A","6.8_ref",13,"065066",8,3,11,6
2136880,2143770,"B","6.9_ref",2,"065066",2,15,17,6
2150660,2156870,"A","6.10_ref",9,"065066",6,2,8,6
2162570,2175180,"B","6.11_ref",6,"065066",17,27,44,6
2188100,2192580,"A","6.12_ref",1,"065066",3,1,4,6
2206950,2211650,"B","6.13_ref",16,"065066",1,6,7,6
2215530,2222410,"A","6.14_ref",5,"065066",6,3,9,6
2225060,2233030,"B","6.15_ref",12,"065066",5,13,18,6
2243400,2250230,"A","6.16_ref",15,"065066",11,3,14,6
14890,79080,"B","1.1_ref",9,"067068",41,106,147,1
111430,131730,"A","1.2_ref",6,"067068",44,16,60,1
186330,213270,"B","1.3_ref",15,"067068",26,45,71,1
224950,246510,"A","1.4_ref",14,"067068",37,13,50,1
254570,274690,"B","1.5_ref",13,"067068",26,38,64,1
290350,379450,"A","1.6_ref",16,"067068",144,107,251,1
396920,420150,"B","1.7_ref",11,"067068",13,43,56,1
456360,479410,"A","1.8_ref",8,"067068",48,20,68,1
497810,506660,"B","1.9_ref",3,"067068",5,13,18,1
527490,561180,"A","1.10_ref",10,"067068",62,17,79,1
600630,622390,"B","1.11_ref",5,"067068",7,43,50,1
636010,669430,"A","1.12_ref",4,"067068",55,39,94,1
720290,748640,"B","1.13_ref",7,"067068",12,50,62,1
786750,816280,"A","1.14_ref",2,"067068",56,14,70,1
827110,842380,"B","1.15_ref",1,"067068",13,38,51,1
860450,887690,"A","1.16_ref",12,"067068",60,8,68,1
903700,927000,"B","2.1_ref",14,"067068",38,42,80,2
933520,954410,"A","2.2_ref",9,"067068",42,9,51,2
965360,988970,"B","2.3_ref",16,"067068",10,41,51,2
994410,1000920,"A","2.4_ref",3,"067068",7,4,11,2
1020850,1033080,"B","2.5_ref",10,"067068",6,31,37,2
1081290,1096860,"A","2.6_ref",11,"067068",26,2,28,2
1106380,1123930,"B","2.7_ref",12,"067068",7,26,33,2
1131860,1144590,"A","2.8_ref",7,"067068",21,8,29,2
1158100,1178900,"B","2.9_ref",6,"067068",15,41,56,2
1265540,1274840,"A","2.10_ref",13,"067068",24,2,26,2
1278130,1291480,"B","2.11_ref",2,"067068",6,25,31,2
1299380,1319750,"A","2.12_ref",15,"067068",31,19,50,2
1338360,1378020,"B","2.13_ref",8,"067068",32,80,112,2
1384860,1393950,"A","2.14_ref",1,"067068",16,4,20,2
1399860,1411400,"B","2.15_ref",4,"067068",8,24,32,2
1421610,1434060,"A","2.16_ref",5,"067068",26,4,30,2
1440950,1467400,"B","3.1_ref",9,"067068",11,49,60,3
1475430,1487200,"A","3.2_ref",10,"067068",21,6,27,3
1510480,1521140,"B","3.3_ref",15,"067068",7,11,18,3
1531950,1541940,"A","3.4_ref",12,"067068",16,2,18,3
1555400,1563120,"B","3.5_ref",1,"067068",3,17,20,3
1580270,1590090,"A","3.6_ref",4,"067068",6,4,10,3
1600490,1609150,"B","3.7_ref",7,"067068",6,17,23,3
1616090,1632820,"A","3.8_ref",16,"067068",33,12,45,3
1653170,1657600,"B","3.9_ref",13,"067068",4,5,9,3
1677890,1686840,"A","3.10_ref",2,"067068",19,4,23,3
1699320,1719870,"B","3.11_ref",11,"067068",16,33,49,3
1730260,1745370,"A","3.12_ref",6,"067068",17,15,32,3
1762910,1770960,"B","3.13_ref",5,"067068",3,18,21,3
1776160,1787120,"A","3.14_ref",8,"067068",16,4,20,3
1827620,1832230,"B","3.15_ref",3,"067068",3,5,8,3
1838050,1857350,"A","3.16_ref",14,"067068",33,11,44,3
1876670,1883660,"B","4.1_ref",10,"067068",3,13,16,4
1896020,1910680,"A","4.2_ref",15,"067068",8,9,17,4
1927190,1930730,"B","4.3_ref",6,"067068",4,10,14,4
1950250,1957750,"A","4.4_ref",1,"067068",16,1,17,4
1962160,1977950,"B","4.5_ref",16,"067068",1,29,30,4
1996530,2003460,"A","4.6_ref",13,"067068",8,5,13,4
2037160,2048840,"B","4.7_ref",12,"067068",3,16,19,4
2066970,2082420,"A","4.8_ref",7,"067068",15,7,22,4
2104640,2112240,"B","4.9_ref",2,"067068",4,18,22,4
2121050,2130110,"A","4.10_ref",9,"067068",17,6,23,4
2142520,2152600,"B","4.11_ref",14,"067068",6,15,21,4
2164030,2177880,"A","4.12_ref",5,"067068",18,3,21,4
2189830,2211450,"B","4.13_ref",8,"067068",11,46,57,4
2223410,2241060,"A","4.14_ref",11,"067068",21,19,40,4
2244880,2255670,"B","4.15_ref",4,"067068",6,8,14,4
2262720,2268150,"A","4.16_ref",3,"067068",3,5,8,4
2277510,2302290,"B","5.1_ref",7,"067068",25,35,60,5
2331550,2337610,"A","5.2_ref",6,"067068",11,2,13,5
2348710,2358540,"B","5.3_ref",11,"067068",2,18,20,5
2371010,2377780,"A","5.4_ref",10,"067068",10,3,13,5
2384220,2392340,"B","5.5_ref",9,"067068",3,7,10,5
2402350,2407440,"A","5.6_ref",4,"067068",4,7,11,5
2424300,2428420,"B","5.7_ref",13,"067068",3,6,9,5
2437150,2444020,"A","5.8_ref",12,"067068",10,3,13,5
2450350,2455810,"B","5.9_ref",1,"067068",1,14,15,5
2462150,2469530,"A","5.10_ref",8,"067068",16,3,19,5
2476870,2482940,"B","5.11_ref",15,"067068",1,7,8,5
2501360,2521350,"A","5.12_ref",14,"067068",18,6,24,5
2592470,2601210,"B","5.13_ref",5,"067068",2,19,21,5
2613180,2633500,"A","5.14_ref",16,"067068",33,15,48,5
2645530,2653050,"B","5.15_ref",3,"067068",2,6,8,5
2658380,2667540,"A","5.16_ref",2,"067068",20,2,22,5
2672790,2685440,"B","6.1_ref",10,"067068",11,18,29,6
2693040,2701860,"A","6.2_ref",11,"067068",16,3,19,6
2711320,2718870,"B","6.3_ref",8,"067068",2,22,24,6
2730380,2738250,"A","6.4_ref",7,"067068",15,3,18,6
2748650,2752460,"B","6.5_ref",4,"067068",3,4,7,6
2759850,2767420,"A","6.6_ref",3,"067068",3,3,6,6
2773410,2779380,"B","6.7_ref",14,"067068",2,12,14,6
2783880,2789880,"A","6.8_ref",13,"067068",5,5,10,6
2795860,2805160,"B","6.9_ref",2,"067068",3,20,23,6
2814430,2824530,"A","6.10_ref",9,"067068",8,9,17,6
2834770,2844040,"B","6.11_ref",6,"067068",10,17,27,6
2855970,2863000,"A","6.12_ref",1,"067068",6,3,9,6
2911610,2920630,"B","6.13_ref",16,"067068",3,19,22,6
2927300,2939190,"A","6.14_ref",5,"067068",18,6,24,6
2944850,2955730,"B","6.15_ref",12,"067068",4,11,15,6
2961190,2967520,"A","6.16_ref",15,"067068",6,1,7,6
44150,86570,"B","1.1_ref",9,"069070",49,62,111,1
107380,125400,"A","1.2_ref",6,"069070",42,21,63,1
138690,155790,"B","1.3_ref",15,"069070",16,20,36,1
175020,202330,"A","1.4_ref",14,"069070",49,17,66,1
217330,231490,"B","1.5_ref",13,"069070",16,26,42,1
258360,276600,"A","1.6_ref",16,"069070",47,13,60,1
286800,353270,"B","1.7_ref",11,"069070",45,107,152,1
381390,397340,"A","1.8_ref",8,"069070",40,14,54,1
411710,428880,"B","1.9_ref",3,"069070",5,42,47,1
437540,455050,"A","1.10_ref",10,"069070",41,7,48,1
461260,481860,"B","1.11_ref",5,"069070",19,37,56,1
489740,501760,"A","1.12_ref",4,"069070",31,6,37,1
514600,535460,"B","1.13_ref",7,"069070",19,46,65,1
550860,572880,"A","1.14_ref",2,"069070",51,16,67,1
577780,589920,"B","1.15_ref",1,"069070",6,30,36,1
604120,621740,"A","1.16_ref",12,"069070",40,5,45,1
629090,642430,"B","2.1_ref",14,"069070",8,33,41,2
649120,721580,"A","2.2_ref",9,"069070",140,74,214,2
736900,748240,"B","2.3_ref",16,"069070",9,29,38,2
755420,767060,"A","2.4_ref",3,"069070",33,8,41,2
779820,803530,"B","2.5_ref",10,"069070",24,49,73,2
814890,826790,"A","2.6_ref",11,"069070",28,6,34,2
831110,840700,"B","2.7_ref",12,"069070",6,23,29,2
860630,865920,"A","2.8_ref",7,"069070",12,7,19,2
874230,884800,"B","2.9_ref",6,"069070",7,29,36,2
892740,898940,"A","2.10_ref",13,"069070",19,7,26,2
903370,911800,"B","2.11_ref",2,"069070",5,21,26,2
924790,932960,"A","2.12_ref",15,"069070",24,5,29,2
938170,951030,"B","2.13_ref",8,"069070",5,24,29,2
959600,979600,"A","2.14_ref",1,"069070",32,21,53,2
985930,995430,"B","2.15_ref",4,"069070",5,24,29,2
1001770,1011180,"A","2.16_ref",5,"069070",17,11,28,2
1017520,1035670,"B","3.1_ref",9,"069070",9,43,52,3
1040210,1057330,"A","3.2_ref",10,"069070",44,28,72,3
1078510,1088130,"B","3.3_ref",15,"069070",7,22,29,3
1092210,1097030,"A","3.4_ref",12,"069070",10,5,15,3
1105220,1112570,"B","3.5_ref",1,"069070",10,21,31,3
1126010,1132890,"A","3.6_ref",4,"069070",15,6,21,3
1136900,1147720,"B","3.7_ref",7,"069070",12,6,18,3
1152440,1160840,"A","3.8_ref",16,"069070",19,7,26,3
1178600,1186110,"B","3.9_ref",13,"069070",10,15,25,3
1199970,1206750,"A","3.10_ref",2,"069070",14,4,18,3
1235850,1245170,"B","3.11_ref",11,"069070",6,24,30,3
1254030,1263390,"A","3.12_ref",6,"069070",24,5,29,3
1269270,1277040,"B","3.13_ref",5,"069070",4,15,19,3
1288730,1299790,"A","3.14_ref",8,"069070",25,8,33,3
1313500,1320700,"B","3.15_ref",3,"069070",6,13,19,3
1331570,1340560,"A","3.16_ref",14,"069070",23,9,32,3
1347240,1358250,"B","4.1_ref",10,"069070",10,25,35,4
1370170,1376940,"A","4.2_ref",15,"069070",13,6,19,4
1384520,1393420,"B","4.3_ref",6,"069070",6,18,24,4
1411010,1419650,"A","4.4_ref",1,"069070",12,12,24,4
1433350,1442680,"B","4.5_ref",16,"069070",7,23,30,4
1448270,1455180,"A","4.6_ref",13,"069070",13,5,18,4
1460540,1467210,"B","4.7_ref",12,"069070",3,15,18,4
1475010,1480160,"A","4.8_ref",7,"069070",8,7,15,4
1487730,1494550,"B","4.9_ref",2,"069070",5,14,19,4
1504350,1515320,"A","4.10_ref",9,"069070",28,15,43,4
1523870,1530110,"B","4.11_ref",14,"069070",6,19,25,4
1537860,1543650,"A","4.12_ref",5,"069070",12,4,16,4
1550390,1558450,"B","4.13_ref",8,"069070",5,21,26,4
1565240,1573730,"A","4.14_ref",11,"069070",23,7,30,4
1580790,1587710,"B","4.15_ref",4,"069070",5,13,18,4
1594700,1601500,"A","4.16_ref",3,"069070",13,5,18,4
1606490,1612070,"B","5.1_ref",7,"069070",7,6,13,5
1624160,1633590,"A","5.2_ref",6,"069070",22,9,31,5
1645140,1653090,"B","5.3_ref",11,"069070",5,19,24,5
1672540,1680750,"A","5.4_ref",10,"069070",18,5,23,5
1687010,1696670,"B","5.5_ref",9,"069070",10,16,26,5
1707000,1714930,"A","5.6_ref",4,"069070",12,11,23,5
1728930,1737070,"B","5.7_ref",13,"069070",10,17,27,5
1746750,1751880,"A","5.8_ref",12,"069070",7,5,12,5
1763950,1771820,"B","5.9_ref",1,"069070",4,21,25,5
1777280,1786180,"A","5.10_ref",8,"069070",21,6,27,5
1797170,1808730,"B","5.11_ref",15,"069070",5,23,28,5
1816450,1822710,"A","5.12_ref",14,"069070",20,6,26,5
1838590,1844830,"B","5.13_ref",5,"069070",7,15,22,5
1855500,1865020,"A","5.14_ref",16,"069070",18,9,27,5
1874640,1880680,"B","5.15_ref",3,"069070",6,10,16,5
1886280,1893520,"A","5.16_ref",2,"069070",15,2,17,5
1896740,1911030,"B","6.1_ref",10,"069070",10,22,32,6
1919330,1926840,"A","6.2_ref",11,"069070",19,3,22,6
1944600,1951350,"B","6.3_ref",8,"069070",7,15,22,6
1968250,1972620,"A","6.4_ref",7,"069070",5,4,9,6
1982900,1988220,"B","6.5_ref",4,"069070",5,9,14,6
2045750,2052290,"A","6.6_ref",3,"069070",15,3,18,6
2061930,2067690,"B","6.7_ref",14,"069070",5,16,21,6
2076430,2082280,"A","6.8_ref",13,"069070",16,5,21,6
2099350,2106950,"B","6.9_ref",2,"069070",5,18,23,6
2125350,2131820,"A","6.10_ref",9,"069070",14,9,23,6
2135730,2142980,"B","6.11_ref",6,"069070",5,10,15,6
2170900,2177270,"A","6.12_ref",1,"069070",11,6,17,6
2185010,2190830,"B","6.13_ref",16,"069070",4,16,20,6
2195930,2201970,"A","6.14_ref",5,"069070",5,6,11,6
2204710,2210620,"B","6.15_ref",12,"069070",7,12,19,6
2219970,2225970,"A","6.16_ref",15,"069070",16,3,19,6
60030,92470,"B","1.1_ref",9,"075076",30,61,91,1
121550,150880,"A","1.2_ref",6,"075076",74,21,95,1
196010,219010,"B","1.3_ref",15,"075076",28,41,69,1
237730,253580,"A","1.4_ref",14,"075076",30,14,44,1
265630,275830,"B","1.5_ref",13,"075076",6,25,31,1
299820,322040,"A","1.6_ref",16,"075076",50,18,68,1
339120,356260,"B","1.7_ref",11,"075076",21,32,53,1
387220,418020,"A","1.8_ref",8,"075076",71,41,112,1
429530,441580,"B","1.9_ref",3,"075076",14,23,37,1
454720,470240,"A","1.10_ref",10,"075076",31,22,53,1
482760,508140,"B","1.11_ref",5,"075076",30,47,77,1
521450,560000,"A","1.12_ref",4,"075076",69,67,136,1
573250,585240,"B","1.13_ref",7,"075076",13,19,32,1
594270,607380,"A","1.14_ref",2,"075076",23,19,42,1
620740,634900,"B","1.15_ref",1,"075076",12,27,39,1
646670,667170,"A","1.16_ref",12,"075076",54,13,67,1
679880,701070,"B","2.1_ref",14,"075076",24,32,56,2
708240,722470,"A","2.2_ref",9,"075076",25,12,37,2
735810,747160,"B","2.3_ref",16,"075076",10,23,33,2
754740,763530,"A","2.4_ref",3,"075076",11,11,22,2
777910,790960,"B","2.5_ref",10,"075076",13,16,29,2
836270,843910,"A","2.6_ref",11,"075076",13,10,23,2
858790,871410,"B","2.7_ref",12,"075076",8,34,42,2
891750,904390,"A","2.8_ref",7,"075076",33,8,41,2
933000,940380,"B","2.9_ref",6,"075076",6,9,15,2
951530,961230,"A","2.10_ref",13,"075076",26,6,32,2
965990,972080,"B","2.11_ref",2,"075076",5,10,15,2
984750,994980,"A","2.12_ref",15,"075076",27,6,33,2
1006880,1017650,"B","2.13_ref",8,"075076",11,24,35,2
1030340,1040880,"A","2.14_ref",1,"075076",27,6,33,2
1056220,1062850,"B","2.15_ref",4,"075076",6,12,18,2
1078760,1084510,"A","2.16_ref",5,"075076",6,7,13,2
1093430,1103920,"B","3.1_ref",9,"075076",9,20,29,3
1119820,1125710,"A","3.2_ref",10,"075076",7,5,12,3
1135100,1146170,"B","3.3_ref",15,"075076",10,22,32,3
1155920,1163940,"A","3.4_ref",12,"075076",22,4,26,3
1181770,1191090,"B","3.5_ref",1,"075076",15,10,25,3
1200570,1205490,"A","3.6_ref",4,"075076",4,6,10,3
1211670,1218790,"B","3.7_ref",7,"075076",9,11,20,3
1228230,1238150,"A","3.8_ref",16,"075076",30,6,36,3
1248640,1255460,"B","3.9_ref",13,"075076",5,16,21,3
1265150,1279290,"A","3.10_ref",2,"075076",14,16,30,3
1304280,1317010,"B","3.11_ref",11,"075076",7,13,20,3
1327400,1335910,"A","3.12_ref",6,"075076",8,8,16,3
1346110,1353900,"B","3.13_ref",5,"075076",9,5,14,3
1366250,1373310,"A","3.14_ref",8,"075076",11,4,15,3
1404900,1410900,"B","3.15_ref",3,"075076",6,5,11,3
1417230,1422490,"A","3.16_ref",14,"075076",8,3,11,3
1482930,1495380,"B","4.1_ref",10,"075076",15,7,22,4
1533890,1542750,"A","4.2_ref",15,"075076",13,10,23,4
1550280,1556280,"B","4.3_ref",6,"075076",4,8,12,4
1580040,1588160,"A","4.4_ref",1,"075076",10,10,20,4
1598010,1607850,"B","4.5_ref",16,"075076",8,13,21,4
1618950,1624000,"A","4.6_ref",13,"075076",18,4,22,4
1632180,1641610,"B","4.7_ref",12,"075076",9,18,27,4
1651650,1658240,"A","4.8_ref",7,"075076",10,6,16,4
1668230,1674040,"B","4.9_ref",2,"075076",4,7,11,4
1696710,1712330,"A","4.10_ref",9,"075076",35,12,47,4
1719400,1729830,"B","4.11_ref",14,"075076",11,15,26,4
1744960,1751750,"A","4.12_ref",5,"075076",6,8,14,4
1763580,1769740,"B","4.13_ref",8,"075076",4,13,17,4
1779640,1788140,"A","4.14_ref",11,"075076",24,4,28,4
1803600,1808220,"B","4.15_ref",4,"075076",6,2,8,4
1830420,1835420,"A","4.16_ref",3,"075076",5,5,10,4
1859180,1865810,"B","5.1_ref",7,"075076",5,9,14,5
1874850,1880810,"A","5.2_ref",6,"075076",6,4,10,5
1889830,1895760,"B","5.3_ref",11,"075076",3,11,14,5
1912590,1918880,"A","5.4_ref",10,"075076",6,7,13,5
1940230,1950250,"B","5.5_ref",9,"075076",9,24,33,5
1971800,1978000,"A","5.6_ref",4,"075076",4,5,9,5
1997970,2005080,"B","5.7_ref",13,"075076",4,18,22,5
2016040,2029050,"A","5.8_ref",12,"075076",19,17,36,5
2042160,2052160,"B","5.9_ref",1,"075076",6,25,31,5
2061070,2068110,"A","5.10_ref",8,"075076",11,4,15,5
2097150,2106140,"B","5.11_ref",15,"075076",5,19,24,5
2125900,2131210,"A","5.12_ref",14,"075076",13,7,20,5
2160710,2167250,"B","5.13_ref",5,"075076",7,5,12,5
2175320,2182400,"A","5.14_ref",16,"075076",16,2,18,5
2192530,2197170,"B","5.15_ref",3,"075076",2,4,6,5
2207440,2213890,"A","5.16_ref",2,"075076",8,3,11,5
2232970,2241280,"B","6.1_ref",10,"075076",4,9,13,6
2262120,2268440,"A","6.2_ref",11,"075076",14,3,17,6
2284070,2290160,"B","6.3_ref",8,"075076",3,12,15,6
2297140,2303540,"A","6.4_ref",7,"075076",16,3,19,6
2311430,2315540,"B","6.5_ref",4,"075076",3,3,6,6
2329110,2335730,"A","6.6_ref",3,"075076",9,7,16,6
2349710,2356140,"B","6.7_ref",14,"075076",3,17,20,6
2372080,2378740,"A","6.8_ref",13,"075076",20,9,29,6
2383440,2388410,"B","6.9_ref",2,"075076",2,8,10,6
2427000,2435730,"A","6.10_ref",9,"075076",9,10,19,6
2442780,2448010,"B","6.11_ref",6,"075076",3,11,14,6
2475270,2481550,"A","6.12_ref",1,"075076",16,3,19,6
2490220,2498630,"B","6.13_ref",16,"075076",4,12,16,6
2508950,2514340,"A","6.14_ref",5,"075076",5,4,9,6
2523640,2536530,"B","6.15_ref",12,"075076",15,16,31,6
2545640,2551780,"A","6.16_ref",15,"075076",12,3,15,6
25710,70320,"B","1.1_ref",9,"077078",37,85,122,1
88470,112560,"A","1.2_ref",6,"077078",53,9,62,1
144810,167430,"B","1.3_ref",15,"077078",12,46,58,1
184650,207930,"A","1.4_ref",14,"077078",59,12,71,1
222790,236350,"B","1.5_ref",13,"077078",6,29,35,1
259200,287580,"A","1.6_ref",16,"077078",73,22,95,1
301770,327580,"B","1.7_ref",11,"077078",10,79,89,1
346980,423890,"A","1.8_ref",8,"077078",173,64,237,1
437700,457790,"B","1.9_ref",3,"077078",23,48,71,1
469640,491020,"A","1.10_ref",10,"077078",65,3,68,1
506950,565390,"B","1.11_ref",5,"077078",29,137,166,1
576880,597800,"A","1.12_ref",4,"077078",54,9,63,1
631180,647980,"B","1.13_ref",7,"077078",7,34,41,1
666350,687240,"A","1.14_ref",2,"077078",51,24,75,1
700910,720710,"B","1.15_ref",1,"077078",8,54,62,1
737260,753650,"A","1.16_ref",12,"077078",43,7,50,1
777950,798390,"B","2.1_ref",14,"077078",15,47,62,2
811670,830040,"A","2.2_ref",9,"077078",42,10,52,2
840490,869590,"B","2.3_ref",16,"077078",11,71,82,2
887460,902280,"A","2.4_ref",3,"077078",40,7,47,2
913870,932330,"B","2.5_ref",10,"077078",5,43,48,2
948330,957540,"A","2.6_ref",11,"077078",27,4,31,2
965250,975570,"B","2.7_ref",12,"077078",7,18,25,2
991510,999090,"A","2.8_ref",7,"077078",16,5,21,2
1010100,1021870,"B","2.9_ref",6,"077078",4,23,27,2
1059250,1069400,"A","2.10_ref",13,"077078",23,7,30,2
1078140,1096740,"B","2.11_ref",2,"077078",9,41,50,2
1137450,1152070,"A","2.12_ref",15,"077078",33,6,39,2
1163600,1182870,"B","2.13_ref",8,"077078",8,52,60,2
1194000,1216230,"A","2.14_ref",1,"077078",46,16,62,2
1229070,1258810,"B","2.15_ref",4,"077078",42,63,105,2
1274230,1296530,"A","2.16_ref",5,"077078",47,19,66,2
1303340,1322960,"B","3.1_ref",9,"077078",17,47,64,3
1338590,1352840,"A","3.2_ref",10,"077078",33,9,42,3
1381880,1394420,"B","3.3_ref",15,"077078",12,21,33,3
1408920,1417880,"A","3.4_ref",12,"077078",20,5,25,3
1442670,1453870,"B","3.5_ref",1,"077078",10,20,30,3
1488040,1502520,"A","3.6_ref",4,"077078",24,13,37,3
1519480,1526210,"B","3.7_ref",7,"077078",4,5,9,3
1536480,1570230,"A","3.8_ref",16,"077078",88,19,107,3
1595400,1600930,"B","3.9_ref",13,"077078",7,9,16,3
1629460,1639200,"A","3.10_ref",2,"077078",29,6,35,3
1659850,1666230,"B","3.11_ref",11,"077078",4,14,18,3
1686950,1694070,"A","3.12_ref",6,"077078",14,4,18,3
1706790,1725880,"B","3.13_ref",5,"077078",11,48,59,3
1741070,1758510,"A","3.14_ref",8,"077078",46,8,54,3
1774370,1781240,"B","3.15_ref",3,"077078",5,8,13,3
1807110,1818540,"A","3.16_ref",14,"077078",29,6,35,3
1842290,1853290,"B","4.1_ref",10,"077078",6,21,27,4
1875770,1889590,"A","4.2_ref",15,"077078",23,7,30,4
1905310,1910740,"B","4.3_ref",6,"077078",4,5,9,4
1945830,1952780,"A","4.4_ref",1,"077078",14,6,20,4
1982830,1998630,"B","4.5_ref",16,"077078",5,38,43,4
2018540,2024340,"A","4.6_ref",13,"077078",10,4,14,4
2056870,2063280,"B","4.7_ref",12,"077078",3,11,14,4
2092790,2100280,"A","4.8_ref",7,"077078",13,7,20,4
2114040,2121580,"B","4.9_ref",2,"077078",3,12,15,4
2181090,2192130,"A","4.10_ref",9,"077078",26,6,32,4
2216860,2227350,"B","4.11_ref",14,"077078",3,23,26,4
2248090,2257840,"A","4.12_ref",5,"077078",24,3,27,4
2273430,2287490,"B","4.13_ref",8,"077078",9,29,38,4
2305150,2311410,"A","4.14_ref",11,"077078",13,5,18,4
2328690,2336120,"B","4.15_ref",4,"077078",4,14,18,4
2353890,2360660,"A","4.16_ref",3,"077078",11,7,18,4
2377210,2385970,"B","5.1_ref",7,"077078",7,8,15,5
2428790,2436780,"A","5.2_ref",6,"077078",10,8,18,5
2464200,2470290,"B","5.3_ref",11,"077078",6,16,22,5
2497840,2506160,"A","5.4_ref",10,"077078",20,11,31,5
2525710,2541470,"B","5.5_ref",9,"077078",3,39,42,5
2551760,2560650,"A","5.6_ref",4,"077078",5,4,9,5
2591090,2596010,"B","5.7_ref",13,"077078",4,3,7,5
2607360,2613970,"A","5.8_ref",12,"077078",12,3,15,5
2667000,2676900,"B","5.9_ref",1,"077078",6,14,20,5
2698660,2709090,"A","5.10_ref",8,"077078",27,5,32,5
2736850,2745510,"B","5.11_ref",15,"077078",5,6,11,5
2756310,2764430,"A","5.12_ref",14,"077078",19,6,25,5
2795840,2808330,"B","5.13_ref",5,"077078",9,12,21,5
2823410,2834750,"A","5.14_ref",16,"077078",31,5,36,5
2857610,2863150,"B","5.15_ref",3,"077078",3,6,9,5
2892020,2906080,"A","5.16_ref",2,"077078",20,12,32,5
2918700,2924970,"B","6.1_ref",10,"077078",4,4,8,6
2946150,2955620,"A","6.2_ref",11,"077078",8,5,13,6
2982860,2991790,"B","6.3_ref",8,"077078",3,19,22,6
3004930,3012060,"A","6.4_ref",7,"077078",13,8,21,6
3042940,3049310,"B","6.5_ref",4,"077078",3,7,10,6
3077130,3082300,"A","6.6_ref",3,"077078",7,7,14,6
3097900,3105660,"B","6.7_ref",14,"077078",2,14,16,6
3123180,3127440,"A","6.8_ref",13,"077078",8,3,11,6
3152850,3161400,"B","6.9_ref",2,"077078",3,15,18,6
3173910,3187310,"A","6.10_ref",9,"077078",32,14,46,6
3200770,3208610,"B","6.11_ref",6,"077078",3,5,8,6
3221270,3228780,"A","6.12_ref",1,"077078",16,7,23,6
3250570,3268030,"B","6.13_ref",16,"077078",8,21,29,6
3281790,3301170,"A","6.14_ref",5,"077078",32,32,64,6
3315240,3324700,"B","6.15_ref",12,"077078",5,12,17,6
3349080,3357670,"A","6.16_ref",15,"077078",19,5,24,6
39130,150140,"B","1.1_ref",9,"081082",80,195,275,1
174600,193910,"A","1.2_ref",6,"081082",31,27,58,1
237400,255220,"B","1.3_ref",15,"081082",18,30,48,1
272250,288940,"A","1.4_ref",14,"081082",27,24,51,1
302790,317890,"B","1.5_ref",13,"081082",13,18,31,1
338840,361760,"A","1.6_ref",16,"081082",38,9,47,1
375440,407010,"B","1.7_ref",11,"081082",17,45,62,1
426840,473460,"A","1.8_ref",8,"081082",84,35,119,1
492900,508030,"B","1.9_ref",3,"081082",20,22,42,1
535130,585770,"A","1.10_ref",10,"081082",65,43,108,1
617010,634150,"B","1.11_ref",5,"081082",14,19,33,1
644930,682040,"A","1.12_ref",4,"081082",41,21,62,1
699790,712660,"B","1.13_ref",7,"081082",7,21,28,1
724520,741590,"A","1.14_ref",2,"081082",23,19,42,1
758380,780230,"B","1.15_ref",1,"081082",21,42,63,1
791520,809300,"A","1.16_ref",12,"081082",24,15,39,1
820410,830760,"B","2.1_ref",14,"081082",10,14,24,2
835930,852800,"A","2.2_ref",9,"081082",30,13,43,2
862740,884690,"B","2.3_ref",16,"081082",5,48,53,2
919300,930300,"A","2.4_ref",3,"081082",13,12,25,2
944600,957990,"B","2.5_ref",10,"081082",7,28,35,2
966560,985540,"A","2.6_ref",11,"081082",26,25,51,2
1005080,1016470,"B","2.7_ref",12,"081082",5,26,31,2
1037120,1053520,"A","2.8_ref",7,"081082",19,14,33,2
1061170,1068760,"B","2.9_ref",6,"081082",3,6,9,2
1077900,1085270,"A","2.10_ref",13,"081082",12,9,21,2
1092660,1103200,"B","2.11_ref",2,"081082",5,20,25,2
1112230,1122460,"A","2.12_ref",15,"081082",15,8,23,2
1127960,1147940,"B","2.13_ref",8,"081082",9,32,41,2
1158510,1170120,"A","2.14_ref",1,"081082",12,8,20,2
1176640,1192440,"B","2.15_ref",4,"081082",5,15,20,2
1212540,1222500,"A","2.16_ref",5,"081082",15,6,21,2
1228590,1244520,"B","3.1_ref",9,"081082",5,20,25,3
1295210,1306000,"A","3.2_ref",10,"081082",8,15,23,3
1391450,1402070,"B","3.3_ref",15,"081082",6,21,27,3
1406890,1414470,"A","3.4_ref",12,"081082",6,5,11,3
1427100,1436950,"B","3.5_ref",1,"081082",5,20,25,3
1455220,1466340,"A","3.6_ref",4,"081082",15,7,22,3
1469810,1484630,"B","3.7_ref",7,"081082",8,25,33,3
1492940,1514810,"A","3.8_ref",16,"081082",31,18,49,3
1526550,1534200,"B","3.9_ref",13,"081082",4,14,18,3
1547670,1556700,"A","3.10_ref",2,"081082",9,6,15,3
1611990,1619860,"B","3.11_ref",11,"081082",5,15,20,3
1626060,1633840,"A","3.12_ref",6,"081082",3,3,6,3
1640800,1652430,"B","3.13_ref",5,"081082",3,15,18,3
1658140,1666540,"A","3.14_ref",8,"081082",12,5,17,3
1676770,1684760,"B","3.15_ref",3,"081082",1,10,11,3
1701740,1709280,"A","3.16_ref",14,"081082",5,4,9,3
1718970,1729670,"B","4.1_ref",10,"081082",8,12,20,4
1746690,1755690,"A","4.2_ref",15,"081082",16,5,21,4
1761060,1765590,"B","4.3_ref",6,"081082",1,2,3,4
1776420,1791790,"A","4.4_ref",1,"081082",10,8,18,4
1798450,1810570,"B","4.5_ref",16,"081082",5,33,38,4
1818760,1825630,"A","4.6_ref",13,"081082",9,5,14,4
1838030,1851410,"B","4.7_ref",12,"081082",7,7,14,4
1869270,1877840,"A","4.8_ref",7,"081082",9,4,13,4
1884320,1895660,"B","4.9_ref",2,"081082",5,17,22,4
1904350,1931570,"A","4.10_ref",9,"081082",23,16,39,4
1956410,1961760,"B","4.11_ref",14,"081082",3,8,11,4
1969670,1979070,"A","4.12_ref",5,"081082",11,5,16,4
1993920,2000760,"B","4.13_ref",8,"081082",5,12,17,4
2005710,2014400,"A","4.14_ref",11,"081082",10,5,15,4
2020150,2027420,"B","4.15_ref",4,"081082",2,11,13,4
2033740,2041040,"A","4.16_ref",3,"081082",6,4,10,4
2044880,2051170,"B","5.1_ref",7,"081082",1,7,8,5
2063070,2071430,"A","5.2_ref",6,"081082",4,5,9,5
2084180,2093240,"B","5.3_ref",11,"081082",4,15,19,5
2109660,2117610,"A","5.4_ref",10,"081082",6,3,9,5
2123910,2134430,"B","5.5_ref",9,"081082",6,20,26,5
2145580,2153450,"A","5.6_ref",4,"081082",7,5,12,5
2187580,2193680,"B","5.7_ref",13,"081082",1,9,10,5
2199790,2205920,"A","5.8_ref",12,"081082",5,5,10,5
2218710,2225360,"B","5.9_ref",1,"081082",4,12,16,5
2232690,2243680,"A","5.10_ref",8,"081082",13,4,17,5
2251850,2261950,"B","5.11_ref",15,"081082",3,9,12,5
2293010,2299380,"A","5.12_ref",14,"081082",3,2,5,5
2309460,2320620,"B","5.13_ref",5,"081082",6,13,19,5
2331780,2341000,"A","5.14_ref",16,"081082",12,6,18,5
2354020,2360020,"B","5.15_ref",3,"081082",1,7,8,5
2364340,2372990,"A","5.16_ref",2,"081082",8,3,11,5
2375570,2383800,"B","6.1_ref",10,"081082",6,6,12,6
2403310,2410820,"A","6.2_ref",11,"081082",4,3,7,6
2434280,2441670,"B","6.3_ref",8,"081082",5,12,17,6
2452100,2457130,"A","6.4_ref",7,"081082",8,2,10,6
2472340,2481730,"B","6.5_ref",4,"081082",4,8,12,6
2491090,2497950,"A","6.6_ref",3,"081082",3,1,4,6
2504920,2511320,"B","6.7_ref",14,"081082",2,3,5,6
2517610,2526650,"A","6.8_ref",13,"081082",7,4,11,6
2544990,2553610,"B","6.9_ref",2,"081082",2,14,16,6
2571940,2581020,"A","6.10_ref",9,"081082",9,6,15,6
2586980,2592020,"B","6.11_ref",6,"081082",2,2,4,6
2601410,2609730,"A","6.12_ref",1,"081082",8,5,13,6
2619360,2629150,"B","6.13_ref",16,"081082",4,18,22,6
2633110,2640850,"A","6.14_ref",5,"081082",8,1,9,6
2645130,2652250,"B","6.15_ref",12,"081082",4,5,9,6
2661120,2669740,"A","6.16_ref",15,"081082",15,4,19,6
40890,82990,"B","1.1_ref",9,"099100",29,69,98,1
128610,156570,"A","1.2_ref",6,"099100",48,23,71,1
220040,237160,"B","1.3_ref",15,"099100",27,34,61,1
266120,285380,"A","1.4_ref",14,"099100",36,13,49,1
303300,321590,"B","1.5_ref",13,"099100",27,43,70,1
358580,412330,"A","1.6_ref",16,"099100",84,67,151,1
426480,450170,"B","1.7_ref",11,"099100",25,49,74,1
478730,506230,"A","1.8_ref",8,"099100",51,27,78,1
592180,608170,"B","1.9_ref",3,"099100",12,36,48,1
621080,643400,"A","1.10_ref",10,"099100",44,10,54,1
728080,764640,"B","1.11_ref",5,"099100",62,65,127,1
791920,814670,"A","1.12_ref",4,"099100",32,31,63,1
841870,867260,"B","1.13_ref",7,"099100",34,48,82,1
890750,908770,"A","1.14_ref",2,"099100",37,18,55,1
920480,959970,"B","1.15_ref",1,"099100",42,85,127,1
975780,1004400,"A","1.16_ref",12,"099100",56,30,86,1
1017780,1033880,"B","2.1_ref",14,"099100",10,30,40,2
1045260,1065110,"A","2.2_ref",9,"099100",45,18,63,2
1086940,1105490,"B","2.3_ref",16,"099100",19,38,57,2
1124940,1138230,"A","2.4_ref",3,"099100",34,11,45,2
1159570,1215600,"B","2.5_ref",10,"099100",58,111,169,2
1241790,1257230,"A","2.6_ref",11,"099100",34,8,42,2
1265470,1278040,"B","2.7_ref",12,"099100",12,25,37,2
1336360,1354890,"A","2.8_ref",7,"099100",36,17,53,2
1376960,1394190,"B","2.9_ref",6,"099100",19,23,42,2
1448650,1457430,"A","2.10_ref",13,"099100",12,8,20,2
1469990,1482660,"B","2.11_ref",2,"099100",12,22,34,2
1503650,1512510,"A","2.12_ref",15,"099100",9,7,16,2
1526480,1535690,"B","2.13_ref",8,"099100",11,10,21,2
1550450,1557730,"A","2.14_ref",1,"099100",15,6,21,2
1572040,1579140,"B","2.15_ref",4,"099100",9,9,18,2
1625990,1647520,"A","2.16_ref",5,"099100",23,19,42,2
1674390,1685610,"B","3.1_ref",9,"099100",8,30,38,3
1718170,1727000,"A","3.2_ref",10,"099100",22,8,30,3
1816220,1823880,"B","3.3_ref",15,"099100",9,12,21,3
1837170,1847210,"A","3.4_ref",12,"099100",12,8,20,3
1866410,1873610,"B","3.5_ref",1,"099100",9,9,18,3
1885990,1897540,"A","3.6_ref",4,"099100",6,9,15,3
1946540,1953460,"B","3.7_ref",7,"099100",10,6,16,3
1965230,1974470,"A","3.8_ref",16,"099100",19,5,24,3
2007540,2014420,"B","3.9_ref",13,"099100",8,7,15,3
2134450,2141370,"A","3.10_ref",2,"099100",10,4,14,3
2158280,2170190,"B","3.11_ref",11,"099100",12,21,33,3
2183350,2193340,"A","3.12_ref",6,"099100",21,7,28,3
2222030,2231530,"B","3.13_ref",5,"099100",12,13,25,3
2244480,2250260,"A","3.14_ref",8,"099100",10,3,13,3
2265060,2271670,"B","3.15_ref",3,"099100",5,10,15,3
2289650,2299500,"A","3.16_ref",14,"099100",18,5,23,3
2319640,2336380,"B","4.1_ref",10,"099100",25,27,52,4
2370540,2377420,"A","4.2_ref",15,"099100",6,3,9,4
2389450,2396120,"B","4.3_ref",6,"099100",6,11,17,4
2415230,2424200,"A","4.4_ref",1,"099100",8,5,13,4
2459050,2469450,"B","4.5_ref",16,"099100",10,12,22,4
2477830,2483780,"A","4.6_ref",13,"099100",8,7,15,4
2498120,2507120,"B","4.7_ref",12,"099100",9,9,18,4
2530190,2535500,"A","4.8_ref",7,"099100",9,4,13,4
2546620,2553700,"B","4.9_ref",2,"099100",7,12,19,4
2567790,2577190,"A","4.10_ref",9,"099100",18,5,23,4
2614420,2622050,"B","4.11_ref",14,"099100",8,6,14,4
2668820,2676630,"A","4.12_ref",5,"099100",10,3,13,4
2689090,2697600,"B","4.13_ref",8,"099100",6,7,13,4
2715310,2725120,"A","4.14_ref",11,"099100",17,5,22,4
2738970,2744400,"B","4.15_ref",4,"099100",6,6,12,4
2792480,2798960,"A","4.16_ref",3,"099100",6,5,11,4
2812930,2820190,"B","5.1_ref",7,"099100",7,6,13,5
2850920,2859750,"A","5.2_ref",6,"099100",11,8,19,5
2883780,2891470,"B","5.3_ref",11,"099100",8,14,22,5
2939730,2953660,"A","5.4_ref",10,"099100",20,10,30,5
2972090,2979750,"B","5.5_ref",9,"099100",6,18,24,5
2989230,2995010,"A","5.6_ref",4,"099100",5,5,10,5
3019850,3025760,"B","5.7_ref",13,"099100",7,9,16,5
3051410,3058730,"A","5.8_ref",12,"099100",12,4,16,5
3078210,3084110,"B","5.9_ref",1,"099100",6,6,12,5
3138070,3145220,"A","5.10_ref",8,"099100",5,6,11,5
3180830,3187780,"B","5.11_ref",15,"099100",8,7,15,5
3210290,3217570,"A","5.12_ref",14,"099100",12,4,16,5
3254590,3263380,"B","5.13_ref",5,"099100",9,8,17,5
3280990,3294190,"A","5.14_ref",16,"099100",19,10,29,5
3314390,3321120,"B","5.15_ref",3,"099100",8,4,12,5
3333150,3340840,"A","5.16_ref",2,"099100",8,5,13,5
3347070,3355300,"B","6.1_ref",10,"099100",7,9,16,6
3369470,3376470,"A","6.2_ref",11,"099100",12,5,17,6
3391130,3399080,"B","6.3_ref",8,"099100",8,6,14,6
3421330,3429140,"A","6.4_ref",7,"099100",10,4,14,6
3444330,3449480,"B","6.5_ref",4,"099100",7,5,12,6
3467900,3473790,"A","6.6_ref",3,"099100",6,5,11,6
3485130,3492160,"B","6.7_ref",14,"099100",6,9,15,6
3507680,3514610,"A","6.8_ref",13,"099100",6,4,10,6
3525510,3531660,"B","6.9_ref",2,"099100",4,12,16,6
3543950,3553680,"A","6.10_ref",9,"099100",18,6,24,6
3567720,3576140,"B","6.11_ref",6,"099100",8,12,20,6
3585720,3592410,"A","6.12_ref",1,"099100",6,4,10,6
3673410,3686690,"B","6.13_ref",16,"099100",14,12,26,6
3714480,3722710,"A","6.14_ref",5,"099100",6,8,14,6
3739160,3747020,"B","6.15_ref",12,"099100",8,7,15,6
3757650,3764520,"A","6.16_ref",15,"099100",6,6,12,6
4370,49960,"B","1.1_ref",9,"101102",61,87,148,1
103620,134430,"A","1.2_ref",6,"101102",76,24,100,1
170490,213770,"B","1.3_ref",15,"101102",33,41,74,1
265930,285970,"A","1.4_ref",14,"101102",47,10,57,1
326200,344800,"B","1.5_ref",13,"101102",16,42,58,1
380050,436150,"A","1.6_ref",16,"101102",118,36,154,1
459120,485280,"B","1.7_ref",11,"101102",28,65,93,1
604850,628700,"A","1.8_ref",8,"101102",52,7,59,1
660090,679740,"B","1.9_ref",3,"101102",11,45,56,1
712910,738870,"A","1.10_ref",10,"101102",61,13,74,1
756170,800570,"B","1.11_ref",5,"101102",24,74,98,1
869740,893840,"A","1.12_ref",4,"101102",57,9,66,1
924750,937870,"B","1.13_ref",7,"101102",9,30,39,1
968010,991190,"A","1.14_ref",2,"101102",57,9,66,1
1012500,1024460,"B","1.15_ref",1,"101102",7,23,30,1
1045420,1069860,"A","1.16_ref",12,"101102",54,9,63,1
1081800,1095930,"B","2.1_ref",14,"101102",8,23,31,2
1104230,1117850,"A","2.2_ref",9,"101102",27,4,31,2
1154940,1196040,"B","2.3_ref",16,"101102",36,75,111,2
1250690,1259610,"A","2.4_ref",3,"101102",15,3,18,2
1286380,1296690,"B","2.5_ref",10,"101102",3,19,22,2
1310920,1328670,"A","2.6_ref",11,"101102",36,5,41,2
1347230,1359300,"B","2.7_ref",12,"101102",3,33,36,2
1390950,1401570,"A","2.8_ref",7,"101102",13,3,16,2
1418310,1430230,"B","2.9_ref",6,"101102",8,21,29,2
1446480,1461400,"A","2.10_ref",13,"101102",30,4,34,2
1470690,1481130,"B","2.11_ref",2,"101102",10,24,34,2
1497670,1510720,"A","2.12_ref",15,"101102",19,14,33,2
1528790,1550560,"B","2.13_ref",8,"101102",9,39,48,2
1578060,1587340,"A","2.14_ref",1,"101102",12,3,15,2
1622530,1636500,"B","2.15_ref",4,"101102",3,25,28,2
1658170,1679860,"A","2.16_ref",5,"101102",44,9,53,2
1700470,1713060,"B","3.1_ref",9,"101102",3,26,29,3
1726840,1734400,"A","3.2_ref",10,"101102",5,6,11,3
1753210,1760420,"B","3.3_ref",15,"101102",4,9,13,3
1774370,1782220,"A","3.4_ref",12,"101102",9,4,13,3
1799150,1807680,"B","3.5_ref",1,"101102",2,7,9,3
1826420,1835200,"A","3.6_ref",4,"101102",21,3,24,3
1846210,1853910,"B","3.7_ref",7,"101102",2,14,16,3
1860760,1872590,"A","3.8_ref",16,"101102",27,3,30,3
1889630,1897750,"B","3.9_ref",13,"101102",3,12,15,3
1922240,1928720,"A","3.10_ref",2,"101102",9,1,10,3
1954190,1969360,"B","3.11_ref",11,"101102",8,34,42,3
1998560,2005730,"A","3.12_ref",6,"101102",10,2,12,3
2026430,2034990,"B","3.13_ref",5,"101102",3,18,21,3
2041170,2056340,"A","3.14_ref",8,"101102",22,6,28,3
2093190,2100550,"B","3.15_ref",3,"101102",4,8,12,3
2119400,2129380,"A","3.16_ref",14,"101102",7,3,10,3
2141220,2147660,"B","4.1_ref",10,"101102",4,3,7,4
2168130,2202810,"A","4.2_ref",15,"101102",36,56,92,4
2212360,2217260,"B","4.3_ref",6,"101102",2,4,6,4
2231680,2237370,"A","4.4_ref",1,"101102",6,3,9,4
2258600,2267800,"B","4.5_ref",16,"101102",3,20,23,4
2290990,2299540,"A","4.6_ref",13,"101102",14,2,16,4
2311730,2319300,"B","4.7_ref",12,"101102",2,9,11,4
2329910,2338610,"A","4.8_ref",7,"101102",7,4,11,4
2349340,2355660,"B","4.9_ref",2,"101102",1,8,9,4
2369030,2376330,"A","4.10_ref",9,"101102",16,5,21,4
2387840,2392450,"B","4.11_ref",14,"101102",3,4,7,4
2406390,2413040,"A","4.12_ref",5,"101102",17,2,19,4
2429130,2440560,"B","4.13_ref",8,"101102",4,18,22,4
2460660,2479380,"A","4.14_ref",11,"101102",35,16,51,4
2493070,2499710,"B","4.15_ref",4,"101102",3,11,14,4
2512390,2517240,"A","4.16_ref",3,"101102",7,1,8,4
2529800,2535880,"B","5.1_ref",7,"101102",1,13,14,5
2554700,2561300,"A","5.2_ref",6,"101102",4,4,8,5
2568870,2577910,"B","5.3_ref",11,"101102",4,23,27,5
2593330,2600410,"A","5.4_ref",10,"101102",3,2,5,5
2615970,2626480,"B","5.5_ref",9,"101102",3,14,17,5
2648960,2655350,"A","5.6_ref",4,"101102",8,5,13,5
2662610,2667340,"B","5.7_ref",13,"101102",2,7,9,5
2674230,2679590,"A","5.8_ref",12,"101102",10,3,13,5
2693180,2701190,"B","5.9_ref",1,"101102",1,4,5,5
2711160,2719290,"A","5.10_ref",8,"101102",13,3,16,5
2726220,2732900,"B","5.11_ref",15,"101102",3,8,11,5
2750800,2757740,"A","5.12_ref",14,"101102",4,3,7,5
2766990,2773270,"B","5.13_ref",5,"101102",2,9,11,5
2793180,2803730,"A","5.14_ref",16,"101102",16,6,22,5
2811200,2817840,"B","5.15_ref",3,"101102",4,4,8,5
2840370,2846210,"A","5.16_ref",2,"101102",3,5,8,5
2852780,2860380,"B","6.1_ref",10,"101102",1,7,8,6
2868710,2880490,"A","6.2_ref",11,"101102",26,3,29,6
2889890,2897430,"B","6.3_ref",8,"101102",3,9,12,6
2911780,2916490,"A","6.4_ref",7,"101102",5,1,6,6
2925990,2933760,"B","6.5_ref",4,"101102",2,9,11,6
2943910,2948300,"A","6.6_ref",3,"101102",5,1,6,6
2956070,2962630,"B","6.7_ref",14,"101102",3,6,9,6
2971460,2976160,"A","6.8_ref",13,"101102",4,2,6,6
2987200,2992920,"B","6.9_ref",2,"101102",1,5,6,6
3001650,3011970,"A","6.10_ref",9,"101102",13,2,15,6
3020800,3026540,"B","6.11_ref",6,"101102",2,3,5,6
3035240,3040870,"A","6.12_ref",1,"101102",2,4,6,6
3051820,3062530,"B","6.13_ref",16,"101102",8,8,16,6
3074230,3080540,"A","6.14_ref",5,"101102",7,2,9,6
3091940,3098320,"B","6.15_ref",12,"101102",2,9,11,6
3105380,3111010,"A","6.16_ref",15,"101102",3,1,4,6
6920,36040,"B","1.1_ref",9,"107108",38,56,94,1
66600,84280,"A","1.2_ref",6,"107108",36,21,57,1
102760,132380,"B","1.3_ref",15,"107108",18,79,97,1
156290,189120,"A","1.4_ref",14,"107108",79,47,126,1
208690,234140,"B","1.5_ref",13,"107108",16,66,82,1
257460,283720,"A","1.6_ref",16,"107108",62,16,78,1
304100,353170,"B","1.7_ref",11,"107108",44,115,159,1
378710,403950,"A","1.8_ref",8,"107108",73,35,108,1
420630,474720,"B","1.9_ref",3,"107108",54,121,175,1
500100,530530,"A","1.10_ref",10,"107108",56,43,99,1
550080,615590,"B","1.11_ref",5,"107108",57,135,192,1
660940,693680,"A","1.12_ref",4,"107108",60,21,81,1
732920,758280,"B","1.13_ref",7,"107108",37,54,91,1
772640,791950,"A","1.14_ref",2,"107108",28,19,47,1
815210,832120,"B","1.15_ref",1,"107108",22,34,56,1
849600,871540,"A","1.16_ref",12,"107108",26,29,55,1
881370,899270,"B","2.1_ref",14,"107108",13,34,47,2
907210,932110,"A","2.2_ref",9,"107108",54,29,83,2
951390,970790,"B","2.3_ref",16,"107108",12,36,48,2
990390,1001850,"A","2.4_ref",3,"107108",12,12,24,2
1045690,1067770,"B","2.5_ref",10,"107108",29,32,61,2
1090180,1101420,"A","2.6_ref",11,"107108",13,15,28,2
1113630,1122430,"B","2.7_ref",12,"107108",5,15,20,2
1147720,1157950,"A","2.8_ref",7,"107108",23,12,35,2
1177460,1193280,"B","2.9_ref",6,"107108",21,35,56,2
1212310,1222340,"A","2.10_ref",13,"107108",16,12,28,2
1231510,1244130,"B","2.11_ref",2,"107108",13,23,36,2
1272440,1292860,"A","2.12_ref",15,"107108",34,25,59,2
1302530,1314180,"B","2.13_ref",8,"107108",8,25,33,2
1333890,1343420,"A","2.14_ref",1,"107108",13,9,22,2
1367630,1380500,"B","2.15_ref",4,"107108",15,37,52,2
1407090,1432000,"A","2.16_ref",5,"107108",35,36,71,2
1442500,1453250,"B","3.1_ref",9,"107108",7,31,38,3
1458630,1469970,"A","3.2_ref",10,"107108",8,10,18,3
1551310,1560820,"B","3.3_ref",15,"107108",6,19,25,3
1564410,1573350,"A","3.4_ref",12,"107108",7,7,14,3
1593520,1601630,"B","3.5_ref",1,"107108",5,13,18,3
1676290,1683590,"A","3.6_ref",4,"107108",9,6,15,3
1693100,1703970,"B","3.7_ref",7,"107108",15,32,47,3
1719500,1742600,"A","3.8_ref",16,"107108",45,44,89,3
1773450,1784040,"B","3.9_ref",13,"107108",6,10,16,3
1832110,1841490,"A","3.10_ref",2,"107108",15,3,18,3
1865950,1875140,"B","3.11_ref",11,"107108",4,13,17,3
1899690,1910170,"A","3.12_ref",6,"107108",13,20,33,3
1936230,1953690,"B","3.13_ref",5,"107108",9,17,26,3
1968530,1974440,"A","3.14_ref",8,"107108",9,2,11,3
2002710,2031300,"B","3.15_ref",3,"107108",36,49,85,3
2039720,2061220,"A","3.16_ref",14,"107108",39,15,54,3
2083040,2091550,"B","4.1_ref",10,"107108",4,15,19,4
2104690,2118400,"A","4.2_ref",15,"107108",24,13,37,4
2142230,2149820,"B","4.3_ref",6,"107108",6,6,12,4
2207980,2213560,"A","4.4_ref",1,"107108",11,3,14,4
2242710,2258800,"B","4.5_ref",16,"107108",16,27,43,4
2269100,2277460,"A","4.6_ref",13,"107108",17,8,25,4
2300810,2307930,"B","4.7_ref",12,"107108",5,8,13,4
2350420,2361010,"A","4.8_ref",7,"107108",18,10,28,4
2372660,2382440,"B","4.9_ref",2,"107108",9,20,29,4
2401100,2407440,"A","4.10_ref",9,"107108",7,4,11,4
2442030,2453290,"B","4.11_ref",14,"107108",20,34,54,4
2490100,2506080,"A","4.12_ref",5,"107108",28,26,54,4
2532440,2540920,"B","4.13_ref",8,"107108",9,7,16,4
2554080,2568220,"A","4.14_ref",11,"107108",15,16,31,4
2604040,2610220,"B","4.15_ref",4,"107108",4,8,12,4
2634410,2661900,"A","4.16_ref",3,"107108",46,52,98,4
2672930,2686610,"B","5.1_ref",7,"107108",9,9,18,5
2696990,2707020,"A","5.2_ref",6,"107108",14,15,29,5
2742640,2751450,"B","5.3_ref",11,"107108",7,13,20,5
2788510,2796700,"A","5.4_ref",10,"107108",6,5,11,5
2809790,2817270,"B","5.5_ref",9,"107108",3,10,13,5
2848950,2858800,"A","5.6_ref",4,"107108",4,4,8,5
2881040,2889050,"B","5.7_ref",13,"107108",4,13,17,5
2899170,2906920,"A","5.8_ref",12,"107108",3,3,6,5
2930340,2936080,"B","5.9_ref",1,"107108",5,9,14,5
2955230,2960950,"A","5.10_ref",8,"107108",9,6,15,5
2973760,2982210,"B","5.11_ref",15,"107108",5,17,22,5
2992770,3000450,"A","5.12_ref",14,"107108",10,7,17,5
3061500,3071200,"B","5.13_ref",5,"107108",8,15,23,5
3099490,3109900,"A","5.14_ref",16,"107108",10,8,18,5
3126430,3138400,"B","5.15_ref",3,"107108",17,21,38,5
3153320,3162850,"A","5.16_ref",2,"107108",16,5,21,5
3173680,3190870,"B","6.1_ref",10,"107108",24,24,48,6
3200440,3213230,"A","6.2_ref",11,"107108",10,8,18,6
3235880,3243680,"B","6.3_ref",8,"107108",9,11,20,6
3252360,3258750,"A","6.4_ref",7,"107108",11,4,15,6
3273510,3278510,"B","6.5_ref",4,"107108",4,3,7,6
3335890,3343030,"A","6.6_ref",3,"107108",11,3,14,6
3359890,3369790,"B","6.7_ref",14,"107108",5,9,14,6
3376300,3383550,"A","6.8_ref",13,"107108",10,4,14,6
3419060,3429900,"B","6.9_ref",2,"107108",6,23,29,6
3470110,3481270,"A","6.10_ref",9,"107108",10,6,16,6
3491610,3497370,"B","6.11_ref",6,"107108",6,6,12,6
3511410,3520620,"A","6.12_ref",1,"107108",9,3,12,6
3544920,3554610,"B","6.13_ref",16,"107108",10,12,22,6
3571140,3580870,"A","6.14_ref",5,"107108",7,4,11,6
3602580,3609340,"B","6.15_ref",12,"107108",1,6,7,6
3630870,3642790,"A","6.16_ref",15,"107108",15,20,35,6
4520,43430,"B","1.1_ref",9,"109110",54,70,124,1
64710,85770,"A","1.2_ref",6,"109110",57,25,82,1
141000,178760,"B","1.3_ref",15,"109110",34,93,127,1
254160,290670,"A","1.4_ref",14,"109110",71,43,114,1
311170,330380,"B","1.5_ref",13,"109110",26,41,67,1
354470,469840,"A","1.6_ref",16,"109110",193,142,335,1
488070,510740,"B","1.7_ref",11,"109110",35,48,83,1
544580,568550,"A","1.8_ref",8,"109110",44,34,78,1
594220,607830,"B","1.9_ref",3,"109110",20,34,54,1
618550,648900,"A","1.10_ref",10,"109110",44,70,114,1
663310,702770,"B","1.11_ref",5,"109110",54,54,108,1
713520,737460,"A","1.12_ref",4,"109110",46,36,82,1
748350,758900,"B","1.13_ref",7,"109110",13,18,31,1
772490,795130,"A","1.14_ref",2,"109110",43,35,78,1
809800,826870,"B","1.15_ref",1,"109110",14,32,46,1
840440,872200,"A","1.16_ref",12,"109110",64,32,96,1
885940,908680,"B","2.1_ref",14,"109110",22,35,57,2
919040,929110,"A","2.2_ref",9,"109110",19,9,28,2
945880,966830,"B","2.3_ref",16,"109110",14,44,58,2
976140,997120,"A","2.4_ref",3,"109110",30,34,64,2
1020110,1030620,"B","2.5_ref",10,"109110",9,18,27,2
1037400,1053300,"A","2.6_ref",11,"109110",9,12,21,2
1076130,1090620,"B","2.7_ref",12,"109110",13,17,30,2
1109420,1117430,"A","2.8_ref",7,"109110",6,6,12,2
1143570,1154470,"B","2.9_ref",6,"109110",7,13,20,2
1284010,1303850,"A","2.10_ref",13,"109110",28,19,47,2
1311600,1328230,"B","2.11_ref",2,"109110",10,20,30,2
1341780,1352930,"A","2.12_ref",15,"109110",12,8,20,2
1362070,1381760,"B","2.13_ref",8,"109110",6,39,45,2
1389370,1405710,"A","2.14_ref",1,"109110",28,13,41,2
1420840,1429850,"B","2.15_ref",4,"109110",7,9,16,2
1435770,1453940,"A","2.16_ref",5,"109110",37,19,56,2
1467940,1478360,"B","3.1_ref",9,"109110",4,14,18,3
1483230,1493370,"A","3.2_ref",10,"109110",9,7,16,3
1512800,1521080,"B","3.3_ref",15,"109110",2,8,10,3
1528210,1539440,"A","3.4_ref",12,"109110",12,15,27,3
1553440,1578480,"B","3.5_ref",1,"109110",23,45,68,3
1593380,1601520,"A","3.6_ref",4,"109110",3,6,9,3
1606110,1624770,"B","3.7_ref",7,"109110",14,35,49,3
1630090,1658740,"A","3.8_ref",16,"109110",49,37,86,3
1696730,1705440,"B","3.9_ref",13,"109110",8,15,23,3
1717570,1727380,"A","3.10_ref",2,"109110",16,13,29,3
1742940,1760390,"B","3.11_ref",11,"109110",10,11,21,3
1773560,1781420,"A","3.12_ref",6,"109110",6,8,14,3
1805930,1822800,"B","3.13_ref",5,"109110",4,23,27,3
1829300,1841440,"A","3.14_ref",8,"109110",18,9,27,3
1863730,1870320,"B","3.15_ref",3,"109110",4,4,8,3
1881300,1893360,"A","3.16_ref",14,"109110",15,13,28,3
1915050,1923380,"B","4.1_ref",10,"109110",3,8,11,4
1957400,1968680,"A","4.2_ref",15,"109110",10,5,15,4
1973050,1984870,"B","4.3_ref",6,"109110",2,11,13,4
2013250,2021600,"A","4.4_ref",1,"109110",5,10,15,4
2030170,2038730,"B","4.5_ref",16,"109110",12,15,27,4
2055270,2061770,"A","4.6_ref",13,"109110",7,8,15,4
2076640,2092520,"B","4.7_ref",12,"109110",20,36,56,4
2105890,2114180,"A","4.8_ref",7,"109110",9,5,14,4
2123650,2134830,"B","4.9_ref",2,"109110",3,14,17,4
2145650,2151210,"A","4.10_ref",9,"109110",3,5,8,4
2161750,2173930,"B","4.11_ref",14,"109110",7,13,20,4
2188210,2202070,"A","4.12_ref",5,"109110",24,16,40,4
2231910,2247900,"B","4.13_ref",8,"109110",8,21,29,4
2254130,2268410,"A","4.14_ref",11,"109110",4,9,13,4
2279100,2298880,"B","4.15_ref",4,"109110",34,13,47,4
2304290,2317310,"A","4.16_ref",3,"109110",7,5,12,4
2322940,2329570,"B","5.1_ref",7,"109110",2,10,12,5
2340830,2349910,"A","5.2_ref",6,"109110",8,6,14,5
2363270,2372160,"B","5.3_ref",11,"109110",5,11,16,5
2393800,2405670,"A","5.4_ref",10,"109110",13,6,19,5
2424150,2432630,"B","5.5_ref",9,"109110",2,3,5,5
2444330,2453550,"A","5.6_ref",4,"109110",5,5,10,5
2467280,2473050,"B","5.7_ref",13,"109110",2,3,5,5
2479390,2488850,"A","5.8_ref",12,"109110",5,3,8,5
2497800,2507870,"B","5.9_ref",1,"109110",7,14,21,5
2516480,2526040,"A","5.10_ref",8,"109110",11,4,15,5
2533470,2548140,"B","5.11_ref",15,"109110",3,10,13,5
2560560,2567320,"A","5.12_ref",14,"109110",7,6,13,5
2590480,2600640,"B","5.13_ref",5,"109110",2,10,12,5
2611710,2622490,"A","5.14_ref",16,"109110",11,10,21,5
2630470,2640930,"B","5.15_ref",3,"109110",4,6,10,5
2651200,2664600,"A","5.16_ref",2,"109110",8,5,13,5
2667760,2694220,"B","6.1_ref",10,"109110",17,20,37,6
2705860,2712130,"A","6.2_ref",11,"109110",3,5,8,6
2723590,2729870,"B","6.3_ref",8,"109110",5,12,17,6
2738550,2747020,"A","6.4_ref",7,"109110",6,5,11,6
2755280,2759240,"B","6.5_ref",4,"109110",3,5,8,6
2769280,2775640,"A","6.6_ref",3,"109110",9,3,12,6
2787440,2795000,"B","6.7_ref",14,"109110",2,3,5,6
2799320,2807480,"A","6.8_ref",13,"109110",5,5,10,6
2819710,2825790,"B","6.9_ref",2,"109110",1,6,7,6
2836500,2842560,"A","6.10_ref",9,"109110",2,1,3,6
2853310,2867540,"B","6.11_ref",6,"109110",2,5,7,6
2878380,2889360,"A","6.12_ref",1,"109110",7,9,16,6
2902930,2909970,"B","6.13_ref",16,"109110",3,7,10,6
2916090,2928770,"A","6.14_ref",5,"109110",9,10,19,6
2936520,2947850,"B","6.15_ref",12,"109110",4,3,7,6
2956770,2984050,"A","6.16_ref",15,"109110",29,35,64,6
20650,65470,"B","1.1_ref",9,"119120",18,66,84,1
99350,122220,"A","1.2_ref",6,"119120",41,19,60,1
140720,172590,"B","1.3_ref",15,"119120",28,54,82,1
204720,224220,"A","1.4_ref",14,"119120",37,27,64,1
238270,257150,"B","1.5_ref",13,"119120",11,47,58,1
303750,342150,"A","1.6_ref",16,"119120",70,37,107,1
384210,420830,"B","1.7_ref",11,"119120",43,66,109,1
440190,461610,"A","1.8_ref",8,"119120",50,16,66,1
472120,484840,"B","1.9_ref",3,"119120",13,19,32,1
498230,519670,"A","1.10_ref",10,"119120",46,18,64,1
531900,576880,"B","1.11_ref",5,"119120",32,79,111,1
587560,602520,"A","1.12_ref",4,"119120",38,16,54,1
619900,628330,"B","1.13_ref",7,"119120",11,13,24,1
640190,656320,"A","1.14_ref",2,"119120",30,18,48,1
664550,677720,"B","1.15_ref",1,"119120",9,23,32,1
687790,720980,"A","1.16_ref",12,"119120",66,47,113,1
730500,746430,"B","2.1_ref",14,"119120",17,23,40,2
754340,764050,"A","2.2_ref",9,"119120",13,12,25,2
773670,785610,"B","2.3_ref",16,"119120",12,13,25,2
801020,811470,"A","2.4_ref",3,"119120",12,9,21,2
821840,837140,"B","2.5_ref",10,"119120",17,29,46,2
850850,867300,"A","2.6_ref",11,"119120",34,14,48,2
877540,894620,"B","2.7_ref",12,"119120",13,33,46,2
913230,921770,"A","2.8_ref",7,"119120",5,6,11,2
930020,942470,"B","2.9_ref",6,"119120",14,11,25,2
1011330,1027430,"A","2.10_ref",13,"119120",32,12,44,2
1033350,1050840,"B","2.11_ref",2,"119120",25,27,52,2
1076390,1087180,"A","2.12_ref",15,"119120",20,7,27,2
1095460,1108240,"B","2.13_ref",8,"119120",8,23,31,2
1147700,1153830,"A","2.14_ref",1,"119120",10,4,14,2
1161690,1173710,"B","2.15_ref",4,"119120",14,16,30,2
1199190,1210060,"A","2.16_ref",5,"119120",15,9,24,2
1250160,1277980,"B","3.1_ref",9,"119120",12,24,36,3
1293120,1302550,"A","3.2_ref",10,"119120",22,4,26,3
1327060,1345750,"B","3.3_ref",15,"119120",14,17,31,3
1351430,1359000,"A","3.4_ref",12,"119120",17,7,24,3
1376460,1384830,"B","3.5_ref",1,"119120",4,14,18,3
1398700,1407400,"A","3.6_ref",4,"119120",11,5,16,3
1416740,1425740,"B","3.7_ref",7,"119120",15,4,19,3
1435370,1447720,"A","3.8_ref",16,"119120",5,7,12,3
1463940,1472030,"B","3.9_ref",13,"119120",4,15,19,3
1487720,1500870,"A","3.10_ref",2,"119120",22,17,39,3
1543140,1570270,"B","3.11_ref",11,"119120",24,38,62,3
1581050,1590440,"A","3.12_ref",6,"119120",5,10,15,3
1606900,1620030,"B","3.13_ref",5,"119120",16,10,26,3
1629030,1658430,"A","3.14_ref",8,"119120",40,19,59,3
1694980,1703850,"B","3.15_ref",3,"119120",4,10,14,3
1717930,1725010,"A","3.16_ref",14,"119120",11,4,15,3
1736770,1746430,"B","4.1_ref",10,"119120",3,13,16,4
1761930,1771710,"A","4.2_ref",15,"119120",8,9,17,4
1779840,1786810,"B","4.3_ref",6,"119120",3,7,10,4
1802220,1808560,"A","4.4_ref",1,"119120",6,4,10,4
1815290,1825890,"B","4.5_ref",16,"119120",5,7,12,4
1844820,1857380,"A","4.6_ref",13,"119120",16,13,29,4
1900850,1912080,"B","4.7_ref",12,"119120",3,16,19,4
1921800,1926850,"A","4.8_ref",7,"119120",3,3,6,4
1937000,1948070,"B","4.9_ref",2,"119120",7,15,22,4
1956050,1973470,"A","4.10_ref",9,"119120",17,10,27,4
1982990,1999560,"B","4.11_ref",14,"119120",12,12,24,4
2009970,2019890,"A","4.12_ref",5,"119120",8,6,14,4
2037630,2046830,"B","4.13_ref",8,"119120",11,14,25,4
2062490,2072450,"A","4.14_ref",11,"119120",14,10,24,4
2079660,2088750,"B","4.15_ref",4,"119120",8,9,17,4
2102180,2109100,"A","4.16_ref",3,"119120",6,4,10,4
2118980,2126280,"B","5.1_ref",7,"119120",3,8,11,5
2141980,2149000,"A","5.2_ref",6,"119120",4,6,10,5
2165850,2175460,"B","5.3_ref",11,"119120",6,14,20,5
2194970,2207070,"A","5.4_ref",10,"119120",12,8,20,5
2220910,2234690,"B","5.5_ref",9,"119120",8,11,19,5
2249510,2255260,"A","5.6_ref",4,"119120",10,3,13,5
2265190,2274870,"B","5.7_ref",13,"119120",11,17,28,5
2281230,2291940,"A","5.8_ref",12,"119120",24,5,29,5
2307000,2317860,"B","5.9_ref",1,"119120",6,13,19,5
2343440,2350400,"A","5.10_ref",8,"119120",12,5,17,5
2357190,2369920,"B","5.11_ref",15,"119120",9,10,19,5
2378470,2384800,"A","5.12_ref",14,"119120",11,4,15,5
2405630,2427100,"B","5.13_ref",5,"119120",17,37,54,5
2432210,2440940,"A","5.14_ref",16,"119120",7,4,11,5
2464330,2472100,"B","5.15_ref",3,"119120",4,9,13,5
2482830,2501290,"A","5.16_ref",2,"119120",34,15,49,5
2504610,2514350,"B","6.1_ref",10,"119120",3,9,12,6
2531950,2541760,"A","6.2_ref",11,"119120",17,5,22,6
2560390,2572890,"B","6.3_ref",8,"119120",5,14,19,6
2579010,2585520,"A","6.4_ref",7,"119120",4,2,6,6
2595720,2603770,"B","6.5_ref",4,"119120",5,6,11,6
2612260,2617710,"A","6.6_ref",3,"119120",5,3,8,6
2635900,2642510,"B","6.7_ref",14,"119120",2,6,8,6
2649450,2659280,"A","6.8_ref",13,"119120",11,8,19,6
2679100,2686760,"B","6.9_ref",2,"119120",4,7,11,6
2704010,2713470,"A","6.10_ref",9,"119120",5,5,10,6
2720930,2729150,"B","6.11_ref",6,"119120",5,8,13,6
2739150,2744850,"A","6.12_ref",1,"119120",7,8,15,6
2751840,2763940,"B","6.13_ref",16,"119120",8,18,26,6
2772470,2780760,"A","6.14_ref",5,"119120",21,8,29,6
2785480,2792880,"B","6.15_ref",12,"119120",6,14,20,6
2816070,2823030,"A","6.16_ref",15,"119120",9,7,16,6
4810,30360,"B","1.1_ref",9,"121122",28,33,61,1
44210,65440,"A","1.2_ref",6,"121122",51,16,67,1
75770,91100,"B","1.3_ref",15,"121122",25,16,41,1
102860,123380,"A","1.4_ref",14,"121122",42,14,56,1
136730,151320,"B","1.5_ref",13,"121122",18,22,40,1
169760,211780,"A","1.6_ref",16,"121122",86,44,130,1
244730,279770,"B","1.7_ref",11,"121122",43,64,107,1
306730,342240,"A","1.8_ref",8,"121122",74,17,91,1
355070,372810,"B","1.9_ref",3,"121122",18,22,40,1
380840,400340,"A","1.10_ref",10,"121122",36,15,51,1
410270,452670,"B","1.11_ref",5,"121122",27,51,78,1
461570,489610,"A","1.12_ref",4,"121122",49,16,65,1
501730,518180,"B","1.13_ref",7,"121122",21,18,39,1
545560,564210,"A","1.14_ref",2,"121122",43,27,70,1
575850,605020,"B","1.15_ref",1,"121122",27,47,74,1
614650,635540,"A","1.16_ref",12,"121122",53,9,62,1
653390,670100,"B","2.1_ref",14,"121122",17,28,45,2
679320,716070,"A","2.2_ref",9,"121122",80,30,110,2
726370,737660,"B","2.3_ref",16,"121122",9,19,28,2
747490,756380,"A","2.4_ref",3,"121122",12,6,18,2
767070,779200,"B","2.5_ref",10,"121122",4,23,27,2
795690,807640,"A","2.6_ref",11,"121122",19,10,29,2
818820,832530,"B","2.7_ref",12,"121122",14,16,30,2
848200,856120,"A","2.8_ref",7,"121122",9,5,14,2
863050,869000,"B","2.9_ref",6,"121122",6,3,9,2
890150,898320,"A","2.10_ref",13,"121122",12,3,15,2
904510,914280,"B","2.11_ref",2,"121122",9,20,29,2
928230,937970,"A","2.12_ref",15,"121122",18,6,24,2
944970,956590,"B","2.13_ref",8,"121122",8,24,32,2
967570,974800,"A","2.14_ref",1,"121122",10,5,15,2
980770,991760,"B","2.15_ref",4,"121122",7,18,25,2
1021470,1028670,"A","2.16_ref",5,"121122",13,4,17,2
1035850,1044860,"B","3.1_ref",9,"121122",6,10,16,3
1053060,1065560,"A","3.2_ref",10,"121122",18,8,26,3
1075100,1083640,"B","3.3_ref",15,"121122",6,9,15,3
1090690,1096400,"A","3.4_ref",12,"121122",6,2,8,3
1102420,1108520,"B","3.5_ref",1,"121122",5,4,9,3
1118730,1125590,"A","3.6_ref",4,"121122",11,3,14,3
1136990,1150800,"B","3.7_ref",7,"121122",9,11,20,3
1157940,1167040,"A","3.8_ref",16,"121122",9,6,15,3
1174900,1180550,"B","3.9_ref",13,"121122",2,8,10,3
1188490,1197500,"A","3.10_ref",2,"121122",12,3,15,3
1206150,1217720,"B","3.11_ref",11,"121122",9,13,22,3
1228760,1237590,"A","3.12_ref",6,"121122",3,3,6,3
1246540,1254580,"B","3.13_ref",5,"121122",6,5,11,3
1259590,1267950,"A","3.14_ref",8,"121122",4,3,7,3
1288670,1296820,"B","3.15_ref",3,"121122",9,11,20,3
1307270,1315890,"A","3.16_ref",14,"121122",17,5,22,3
1331080,1347150,"B","4.1_ref",10,"121122",9,11,20,4
1356730,1365710,"A","4.2_ref",15,"121122",10,3,13,4
1370030,1374850,"B","4.3_ref",6,"121122",3,3,6,4
1383510,1389120,"A","4.4_ref",1,"121122",7,3,10,4
1393010,1401450,"B","4.5_ref",16,"121122",7,11,18,4
1412990,1417750,"A","4.6_ref",13,"121122",4,2,6,4
1423940,1433070,"B","4.7_ref",12,"121122",7,4,11,4
1444550,1451420,"A","4.8_ref",7,"121122",10,4,14,4
1462610,1472260,"B","4.9_ref",2,"121122",7,11,18,4
1488630,1499540,"A","4.10_ref",9,"121122",7,3,10,4
1518980,1528090,"B","4.11_ref",14,"121122",7,12,19,4
1543440,1550700,"A","4.12_ref",5,"121122",8,2,10,4
1559520,1568360,"B","4.13_ref",8,"121122",8,5,13,4
1583860,1590170,"A","4.14_ref",11,"121122",9,3,12,4
1600980,1608380,"B","4.15_ref",4,"121122",4,11,15,4
1625910,1631940,"A","4.16_ref",3,"121122",11,4,15,4
1638760,1645930,"B","5.1_ref",7,"121122",9,3,12,5
1649010,1655930,"A","5.2_ref",6,"121122",9,6,15,5
1663080,1669310,"B","5.3_ref",11,"121122",6,8,14,5
1680730,1690060,"A","5.4_ref",10,"121122",17,5,22,5
1695500,1703120,"B","5.5_ref",9,"121122",5,3,8,5
1712480,1720280,"A","5.6_ref",4,"121122",9,4,13,5
1730520,1734710,"B","5.7_ref",13,"121122",3,5,8,5
1746390,1754150,"A","5.8_ref",12,"121122",11,4,15,5
1759680,1767050,"B","5.9_ref",1,"121122",4,7,11,5
1774270,1780880,"A","5.10_ref",8,"121122",5,2,7,5
1794110,1801510,"B","5.11_ref",15,"121122",7,7,14,5
1816550,1824370,"A","5.12_ref",14,"121122",16,3,19,5
1831670,1838440,"B","5.13_ref",5,"121122",8,3,11,5
1860230,1867710,"A","5.14_ref",16,"121122",14,5,19,5
1878660,1885940,"B","5.15_ref",3,"121122",6,6,12,5
1891180,1897490,"A","5.16_ref",2,"121122",9,1,10,5
1901340,1909530,"B","6.1_ref",10,"121122",8,12,20,6
1918400,1923430,"A","6.2_ref",11,"121122",6,2,8,6
1933980,1938940,"B","6.3_ref",8,"121122",7,5,12,6
1948040,1955810,"A","6.4_ref",7,"121122",10,4,14,6
1966130,1974610,"B","6.5_ref",4,"121122",7,13,20,6
1990830,1998050,"A","6.6_ref",3,"121122",9,3,12,6
2007230,2016240,"B","6.7_ref",14,"121122",8,11,19,6
2035290,2042850,"A","6.8_ref",13,"121122",11,5,16,6
2059730,2067440,"B","6.9_ref",2,"121122",4,11,15,6
2085820,2092610,"A","6.10_ref",9,"121122",8,1,9,6
2105190,2111610,"B","6.11_ref",6,"121122",5,5,10,6
2124140,2133480,"A","6.12_ref",1,"121122",7,5,12,6
2149920,2157660,"B","6.13_ref",16,"121122",4,11,15,6
2162960,2171550,"A","6.14_ref",5,"121122",12,4,16,6
2181610,2187540,"B","6.15_ref",12,"121122",6,7,13,6
2203940,2212600,"A","6.16_ref",15,"121122",9,10,19,6
53090,134350,"B","1.1_ref",9,"123124",95,155,250,1
150110,170910,"A","1.2_ref",6,"123124",43,22,65,1
203880,239010,"B","1.3_ref",15,"123124",45,72,117,1
254880,278750,"A","1.4_ref",14,"123124",49,23,72,1
289430,304450,"B","1.5_ref",13,"123124",13,34,47,1
319910,344460,"A","1.6_ref",16,"123124",56,11,67,1
363650,386500,"B","1.7_ref",11,"123124",27,58,85,1
400260,426700,"A","1.8_ref",8,"123124",58,13,71,1
450610,463550,"B","1.9_ref",3,"123124",7,27,34,1
478750,535180,"A","1.10_ref",10,"123124",86,62,148,1
587290,606130,"B","1.11_ref",5,"123124",7,34,41,1
616330,667880,"A","1.12_ref",4,"123124",73,28,101,1
681920,698860,"B","1.13_ref",7,"123124",10,34,44,1
712230,731470,"A","1.14_ref",2,"123124",37,18,55,1
747990,767040,"B","1.15_ref",1,"123124",17,42,59,1
778970,815460,"A","1.16_ref",12,"123124",68,31,99,1
824420,840100,"B","2.1_ref",14,"123124",5,33,38,2
851730,873670,"A","2.2_ref",9,"123124",33,15,48,2
894800,907610,"B","2.3_ref",16,"123124",4,34,38,2
915720,928880,"A","2.4_ref",3,"123124",12,16,28,2
955360,988200,"B","2.5_ref",10,"123124",9,74,83,2
1000390,1032780,"A","2.6_ref",11,"123124",55,27,82,2
1039210,1067640,"B","2.7_ref",12,"123124",14,55,69,2
1103110,1113170,"A","2.8_ref",7,"123124",19,8,27,2
1135130,1143510,"B","2.9_ref",6,"123124",8,21,29,2
1159890,1167990,"A","2.10_ref",13,"123124",13,6,19,2
1175290,1184570,"B","2.11_ref",2,"123124",3,23,26,2
1214450,1232200,"A","2.12_ref",15,"123124",44,14,58,2
1252970,1274390,"B","2.13_ref",8,"123124",13,53,66,2
1283390,1302020,"A","2.14_ref",1,"123124",36,17,53,2
1312150,1320680,"B","2.15_ref",4,"123124",2,18,20,2
1344980,1392490,"A","2.16_ref",5,"123124",71,51,122,2
1404440,1419010,"B","3.1_ref",9,"123124",3,31,34,3
1434090,1444860,"A","3.2_ref",10,"123124",13,12,25,3
1458460,1468590,"B","3.3_ref",15,"123124",2,26,28,3
1476990,1489440,"A","3.4_ref",12,"123124",11,14,25,3
1497460,1510920,"B","3.5_ref",1,"123124",5,31,36,3
1520320,1527150,"A","3.6_ref",4,"123124",6,7,13,3
1534990,1545600,"B","3.7_ref",7,"123124",3,9,12,3
1553470,1563720,"A","3.8_ref",16,"123124",18,5,23,3
1576540,1582350,"B","3.9_ref",13,"123124",4,7,11,3
1620250,1627560,"A","3.10_ref",2,"123124",10,9,19,3
1650390,1664960,"B","3.11_ref",11,"123124",4,31,35,3
1672440,1677770,"A","3.12_ref",6,"123124",8,8,16,3
1700410,1727810,"B","3.13_ref",5,"123124",42,63,105,3
1735370,1747600,"A","3.14_ref",8,"123124",14,12,26,3
1758750,1766040,"B","3.15_ref",3,"123124",6,16,22,3
1781230,1786510,"A","3.16_ref",14,"123124",7,5,12,3
1804270,1822980,"B","4.1_ref",10,"123124",7,50,57,4
1848230,1857930,"A","4.2_ref",15,"123124",9,15,24,4
1870200,1879200,"B","4.3_ref",6,"123124",4,15,19,4
1898270,1906940,"A","4.4_ref",1,"123124",9,4,13,4
1914900,1923910,"B","4.5_ref",16,"123124",2,17,19,4
1935230,1943220,"A","4.6_ref",13,"123124",8,5,13,4
1963140,1972130,"B","4.7_ref",12,"123124",2,10,12,4
1986610,1993480,"A","4.8_ref",7,"123124",6,5,11,4
2002970,2013120,"B","4.9_ref",2,"123124",3,14,17,4
2022060,2034000,"A","4.10_ref",9,"123124",4,9,13,4
2058210,2063930,"B","4.11_ref",14,"123124",3,12,15,4
2082300,2093590,"A","4.12_ref",5,"123124",10,11,21,4
2108340,2120330,"B","4.13_ref",8,"123124",8,16,24,4
2131500,2140390,"A","4.14_ref",11,"123124",4,13,17,4
2153100,2158320,"B","4.15_ref",4,"123124",4,4,8,4
2175540,2182630,"A","4.16_ref",3,"123124",5,8,13,4
2192450,2201830,"B","5.1_ref",7,"123124",1,16,17,5
2214710,2220870,"A","5.2_ref",6,"123124",2,8,10,5
2246950,2253790,"B","5.3_ref",11,"123124",1,14,15,5
2267160,2276680,"A","5.4_ref",10,"123124",10,10,20,5
2291060,2301420,"B","5.5_ref",9,"123124",1,15,16,5
2319650,2328140,"A","5.6_ref",4,"123124",2,6,8,5
2381440,2386170,"B","5.7_ref",13,"123124",5,4,9,5
2405260,2412150,"A","5.8_ref",12,"123124",6,8,14,5
2425910,2436470,"B","5.9_ref",1,"123124",8,20,28,5
2448540,2455050,"A","5.10_ref",8,"123124",5,9,14,5
2470020,2489230,"B","5.11_ref",15,"123124",11,27,38,5
2500450,2505070,"A","5.12_ref",14,"123124",3,7,10,5
2528040,2537720,"B","5.13_ref",5,"123124",12,18,30,5
2559090,2564120,"A","5.14_ref",16,"123124",7,6,13,5
2580490,2587390,"B","5.15_ref",3,"123124",3,11,14,5
2596180,2598940,"A","5.16_ref",2,"123124",3,0,3,5
2609610,2625170,"B","6.1_ref",10,"123124",8,19,27,6
2627500,2634700,"A","6.2_ref",11,"123124",5,7,12,6
2642670,2650610,"B","6.3_ref",8,"123124",6,12,18,6
2661580,2668290,"A","6.4_ref",7,"123124",3,8,11,6
2681360,2685550,"B","6.5_ref",4,"123124",5,2,7,6
2694760,2701030,"A","6.6_ref",3,"123124",4,8,12,6
2719830,2726810,"B","6.7_ref",14,"123124",5,4,9,6
2734160,2738170,"A","6.8_ref",13,"123124",4,3,7,6
2745890,2754380,"B","6.9_ref",2,"123124",1,13,14,6
2761090,2778040,"A","6.10_ref",9,"123124",25,19,44,6
2795460,2800030,"B","6.11_ref",6,"123124",7,7,14,6
2810490,2818600,"A","6.12_ref",1,"123124",5,10,15,6
2832400,2837460,"B","6.13_ref",16,"123124",2,8,10,6
2844140,2852710,"A","6.14_ref",5,"123124",5,14,19,6
2856280,2862700,"B","6.15_ref",12,"123124",4,13,17,6
2871060,2882930,"A","6.16_ref",15,"123124",11,11,22,6
61730,115400,"B","1.1_ref",9,"131132",81,119,200,1
173260,198020,"A","1.2_ref",6,"131132",62,28,90,1
223380,282620,"B","1.3_ref",15,"131132",94,124,218,1
315840,342410,"A","1.4_ref",14,"131132",72,23,95,1
355030,373030,"B","1.5_ref",13,"131132",30,37,67,1
403150,447350,"A","1.6_ref",16,"131132",89,69,158,1
477010,503770,"B","1.7_ref",11,"131132",42,59,101,1
539580,568300,"A","1.8_ref",8,"131132",73,19,92,1
587350,599460,"B","1.9_ref",3,"131132",27,28,55,1
618230,650880,"A","1.10_ref",10,"131132",76,50,126,1
671620,793730,"B","1.11_ref",5,"131132",224,258,482,1
810120,843690,"A","1.12_ref",4,"131132",88,58,146,1
872220,900980,"B","1.13_ref",7,"131132",37,72,109,1
914620,933840,"A","1.14_ref",2,"131132",32,27,59,1
948530,959340,"B","1.15_ref",1,"131132",16,22,38,1
977060,995790,"A","1.16_ref",12,"131132",42,28,70,1
1020460,1035150,"B","2.1_ref",14,"131132",11,31,42,2
1042240,1053240,"A","2.2_ref",9,"131132",25,6,31,2
1067790,1079370,"B","2.3_ref",16,"131132",17,16,33,2
1088930,1093100,"A","2.4_ref",3,"131132",2,3,5,2
1120690,1133900,"B","2.5_ref",10,"131132",16,38,54,2
1208540,1217380,"A","2.6_ref",11,"131132",11,11,22,2
1231960,1254690,"B","2.7_ref",12,"131132",39,50,89,2
1269480,1277560,"A","2.8_ref",7,"131132",12,10,22,2
1294510,1316280,"B","2.9_ref",6,"131132",27,42,69,2
1335590,1346340,"A","2.10_ref",13,"131132",24,18,42,2
1360720,1373820,"B","2.11_ref",2,"131132",9,26,35,2
1395150,1410940,"A","2.12_ref",15,"131132",36,17,53,2
1434520,1463970,"B","2.13_ref",8,"131132",65,74,139,2
1491460,1498930,"A","2.14_ref",1,"131132",8,4,12,2
1515960,1524240,"B","2.15_ref",4,"131132",14,9,23,2
1563160,1573640,"A","2.16_ref",5,"131132",10,15,25,2
1586770,1607190,"B","3.1_ref",9,"131132",17,43,60,3
1633340,1643130,"A","3.2_ref",10,"131132",19,11,30,3
1656670,1673000,"B","3.3_ref",15,"131132",28,34,62,3
1690600,1699410,"A","3.4_ref",12,"131132",20,15,35,3
1725210,1731380,"B","3.5_ref",1,"131132",4,14,18,3
1743410,1748000,"A","3.6_ref",4,"131132",3,3,6,3
1762790,1769390,"B","3.7_ref",7,"131132",4,7,11,3
1784190,1796160,"A","3.8_ref",16,"131132",24,19,43,3
1821960,1827590,"B","3.9_ref",13,"131132",3,10,13,3
1863300,1869460,"A","3.10_ref",2,"131132",5,5,10,3
1883270,1894100,"B","3.11_ref",11,"131132",4,17,21,3
1901940,1910650,"A","3.12_ref",6,"131132",12,5,17,3
1942110,1956240,"B","3.13_ref",5,"131132",22,32,54,3
1980070,1995160,"A","3.14_ref",8,"131132",23,12,35,3
2016920,2022940,"B","3.15_ref",3,"131132",2,4,6,3
2039440,2049000,"A","3.16_ref",14,"131132",17,9,26,3
2064880,2074360,"B","4.1_ref",10,"131132",8,17,25,4
2099420,2104850,"A","4.2_ref",15,"131132",3,4,7,4
2124030,2129740,"B","4.3_ref",6,"131132",3,8,11,4
2149770,2154450,"A","4.4_ref",1,"131132",7,6,13,4
2167990,2173960,"B","4.5_ref",16,"131132",6,12,18,4
2181240,2186710,"A","4.6_ref",13,"131132",6,10,16,4
2215260,2222460,"B","4.7_ref",12,"131132",5,12,17,4
2244560,2250580,"A","4.8_ref",7,"131132",4,7,11,4
2267980,2279340,"B","4.9_ref",2,"131132",16,20,36,4
2292630,2300470,"A","4.10_ref",9,"131132",12,5,17,4
2309680,2330470,"B","4.11_ref",14,"131132",25,22,47,4
2350270,2360530,"A","4.12_ref",5,"131132",8,6,14,4
2386170,2396170,"B","4.13_ref",8,"131132",16,21,37,4
2409280,2420400,"A","4.14_ref",11,"131132",12,6,18,4
2439560,2444680,"B","4.15_ref",4,"131132",2,5,7,4
2455670,2459550,"A","4.16_ref",3,"131132",3,4,7,4
2467070,2472680,"B","5.1_ref",7,"131132",5,15,20,5
2497580,2506850,"A","5.2_ref",6,"131132",8,6,14,5
2535700,2540960,"B","5.3_ref",11,"131132",3,11,14,5
2607560,2621230,"A","5.4_ref",10,"131132",24,14,38,5
2634050,2647030,"B","5.5_ref",9,"131132",18,17,35,5
2662600,2670320,"A","5.6_ref",4,"131132",4,5,9,5
2690210,2695240,"B","5.7_ref",13,"131132",3,6,9,5
2701910,2708910,"A","5.8_ref",12,"131132",8,8,16,5
2733380,2739900,"B","5.9_ref",1,"131132",9,12,21,5
2751760,2760430,"A","5.10_ref",8,"131132",6,10,16,5
2773720,2779520,"B","5.11_ref",15,"131132",3,6,9,5
2792630,2799440,"A","5.12_ref",14,"131132",4,8,12,5
2825680,2836140,"B","5.13_ref",5,"131132",11,17,28,5
2845240,2860110,"A","5.14_ref",16,"131132",14,14,28,5
2878470,2882030,"B","5.15_ref",3,"131132",4,5,9,5
2900580,2907510,"A","5.16_ref",2,"131132",4,4,8,5
2913170,2929260,"B","6.1_ref",10,"131132",22,26,48,6
2944890,2953190,"A","6.2_ref",11,"131132",4,4,8,6
2965900,2974100,"B","6.3_ref",8,"131132",9,8,17,6
2991420,3001450,"A","6.4_ref",7,"131132",4,11,15,6
3008640,3013710,"B","6.5_ref",4,"131132",2,4,6,6
3029030,3033440,"A","6.6_ref",3,"131132",2,8,10,6
3056490,3064310,"B","6.7_ref",14,"131132",9,11,20,6
3086270,3090900,"A","6.8_ref",13,"131132",4,3,7,6
3106520,3114250,"B","6.9_ref",2,"131132",3,6,9,6
3129340,3146110,"A","6.10_ref",9,"131132",10,12,22,6
3149400,3154090,"B","6.11_ref",6,"131132",4,6,10,6
3172300,3180320,"A","6.12_ref",1,"131132",8,13,21,6
3194570,3205260,"B","6.13_ref",16,"131132",1,16,17,6
3219350,3227950,"A","6.14_ref",5,"131132",8,7,15,6
3237500,3243270,"B","6.15_ref",12,"131132",0,8,8,6
3261420,3270130,"A","6.16_ref",15,"131132",4,8,12,6
23530,59750,"B","1.1_ref",9,"135136",44,37,81,1
103740,124990,"A","1.2_ref",6,"135136",30,14,44,1
153780,170170,"B","1.3_ref",15,"135136",12,27,39,1
195600,213160,"A","1.4_ref",14,"135136",23,7,30,1
234120,242940,"B","1.5_ref",13,"135136",9,15,24,1
284730,312500,"A","1.6_ref",16,"135136",60,15,75,1
333540,356820,"B","1.7_ref",11,"135136",34,37,71,1
383570,404580,"A","1.8_ref",8,"135136",22,26,48,1
429570,441030,"B","1.9_ref",3,"135136",6,15,21,1
450280,473370,"A","1.10_ref",10,"135136",45,6,51,1
479500,525930,"B","1.11_ref",5,"135136",36,47,83,1
538790,562780,"A","1.12_ref",4,"135136",36,12,48,1
577850,591800,"B","1.13_ref",7,"135136",9,20,29,1
610550,628690,"A","1.14_ref",2,"135136",31,4,35,1
638980,652850,"B","1.15_ref",1,"135136",12,21,33,1
685880,719630,"A","1.16_ref",12,"135136",76,20,96,1
735310,747410,"B","2.1_ref",14,"135136",15,12,27,2
757980,781510,"A","2.2_ref",9,"135136",50,7,57,2
807490,858450,"B","2.3_ref",16,"135136",31,66,97,2
874660,887740,"A","2.4_ref",3,"135136",13,8,21,2
906030,922600,"B","2.5_ref",10,"135136",11,20,31,2
936120,952930,"A","2.6_ref",11,"135136",32,2,34,2
958940,973310,"B","2.7_ref",12,"135136",20,26,46,2
1019190,1028800,"A","2.8_ref",7,"135136",14,5,19,2
1038140,1054200,"B","2.9_ref",6,"135136",6,29,35,2
1068010,1075370,"A","2.10_ref",13,"135136",13,6,19,2
1081560,1095980,"B","2.11_ref",2,"135136",5,22,27,2
1107170,1117660,"A","2.12_ref",15,"135136",19,4,23,2
1128080,1144980,"B","2.13_ref",8,"135136",18,17,35,2
1152760,1163880,"A","2.14_ref",1,"135136",25,3,28,2
1178480,1188730,"B","2.15_ref",4,"135136",6,16,22,2
1221670,1237430,"A","2.16_ref",5,"135136",22,7,29,2
1255920,1269260,"B","3.1_ref",9,"135136",8,28,36,3
1273880,1294190,"A","3.2_ref",10,"135136",29,8,37,3
1313340,1324730,"B","3.3_ref",15,"135136",14,18,32,3
1332830,1340150,"A","3.4_ref",12,"135136",15,7,22,3
1365940,1373630,"B","3.5_ref",1,"135136",7,11,18,3
1389860,1401210,"A","3.6_ref",4,"135136",22,13,35,3
1406440,1413460,"B","3.7_ref",7,"135136",9,4,13,3
1419610,1435980,"A","3.8_ref",16,"135136",34,5,39,3
1511460,1519450,"B","3.9_ref",13,"135136",5,6,11,3
1543290,1555990,"A","3.10_ref",2,"135136",23,4,27,3
1575910,1587420,"B","3.11_ref",11,"135136",16,8,24,3
1595570,1605850,"A","3.12_ref",6,"135136",24,5,29,3
1614640,1625630,"B","3.13_ref",5,"135136",6,12,18,3
1635460,1645640,"A","3.14_ref",8,"135136",10,7,17,3
1658340,1668250,"B","3.15_ref",3,"135136",4,10,14,3
1679130,1689150,"A","3.16_ref",14,"135136",22,2,24,3
1700170,1713260,"B","4.1_ref",10,"135136",7,15,22,4
1720450,1730740,"A","4.2_ref",15,"135136",23,4,27,4
1737910,1748940,"B","4.3_ref",6,"135136",5,12,17,4
1757600,1767750,"A","4.4_ref",1,"135136",21,6,27,4
1783810,1799550,"B","4.5_ref",16,"135136",20,13,33,4
1817620,1824440,"A","4.6_ref",13,"135136",9,3,12,4
1833960,1843280,"B","4.7_ref",12,"135136",9,12,21,4
1852340,1858730,"A","4.8_ref",7,"135136",4,5,9,4
1873570,1884510,"B","4.9_ref",2,"135136",5,16,21,4
1890570,1907690,"A","4.10_ref",9,"135136",28,13,41,4
1916640,1924750,"B","4.11_ref",14,"135136",7,11,18,4
1931000,1942230,"A","4.12_ref",5,"135136",15,9,24,4
1960600,1968260,"B","4.13_ref",8,"135136",11,8,19,4
1972340,1990010,"A","4.14_ref",11,"135136",31,7,38,4
2002540,2011260,"B","4.15_ref",4,"135136",8,13,21,4
2017400,2024840,"A","4.16_ref",3,"135136",14,2,16,4
2028940,2038420,"B","5.1_ref",7,"135136",12,6,18,5
2050360,2060430,"A","5.2_ref",6,"135136",19,4,23,5
2078010,2088740,"B","5.3_ref",11,"135136",15,16,31,5
2129740,2142200,"A","5.4_ref",10,"135136",26,3,29,5
2170440,2189670,"B","5.5_ref",9,"135136",25,22,47,5
2196470,2205650,"A","5.6_ref",4,"135136",15,5,20,5
2215230,2220590,"B","5.7_ref",13,"135136",7,6,13,5
2235150,2241840,"A","5.8_ref",12,"135136",6,7,13,5
2253750,2262130,"B","5.9_ref",1,"135136",10,12,22,5
2293950,2303080,"A","5.10_ref",8,"135136",16,4,20,5
2310760,2318790,"B","5.11_ref",15,"135136",5,11,16,5
2334670,2340720,"A","5.12_ref",14,"135136",12,3,15,5
2358140,2369530,"B","5.13_ref",5,"135136",12,10,22,5
2379780,2389960,"A","5.14_ref",16,"135136",24,1,25,5
2398130,2404590,"B","5.15_ref",3,"135136",4,11,15,5
2413490,2423680,"A","5.16_ref",2,"135136",21,5,26,5
2426920,2436430,"B","6.1_ref",10,"135136",4,16,20,6
2449010,2462430,"A","6.2_ref",11,"135136",24,3,27,6
2475340,2483020,"B","6.3_ref",8,"135136",9,4,13,6
2489830,2496220,"A","6.4_ref",7,"135136",4,4,8,6
2503390,2511790,"B","6.5_ref",4,"135136",12,6,18,6
2546250,2553600,"A","6.6_ref",3,"135136",10,7,17,6
2574090,2581310,"B","6.7_ref",14,"135136",5,8,13,6
2586340,2591480,"A","6.8_ref",13,"135136",7,3,10,6
2603300,2613540,"B","6.9_ref",2,"135136",4,12,16,6
2625770,2637890,"A","6.10_ref",9,"135136",26,7,33,6
2642690,2654900,"B","6.11_ref",6,"135136",7,15,22,6
2664190,2669620,"A","6.12_ref",1,"135136",5,3,8,6
2678360,2690150,"B","6.13_ref",16,"135136",15,16,31,6
2693020,2702320,"A","6.14_ref",5,"135136",11,11,22,6
2705250,2713620,"B","6.15_ref",12,"135136",9,10,19,6
2724780,2732040,"A","6.16_ref",15,"135136",11,4,15,6
22420,152850,"B","1.1_ref",9,"141142",156,112,268,1
177770,217930,"A","1.2_ref",6,"141142",92,19,111,1
252400,278070,"B","1.3_ref",15,"141142",16,52,68,1
294310,333570,"A","1.4_ref",14,"141142",96,10,106,1
346940,364090,"B","1.5_ref",13,"141142",22,29,51,1
401750,509880,"A","1.6_ref",16,"141142",243,50,293,1
526260,548600,"B","1.7_ref",11,"141142",20,42,62,1
571710,627180,"A","1.8_ref",8,"141142",123,19,142,1
642640,674390,"B","1.9_ref",3,"141142",46,30,76,1
691740,865320,"A","1.10_ref",10,"141142",346,123,469,1
889210,926110,"B","1.11_ref",5,"141142",44,65,109,1
942030,969150,"A","1.12_ref",4,"141142",73,9,82,1
985240,1001740,"B","1.13_ref",7,"141142",33,26,59,1
1014740,1045060,"A","1.14_ref",2,"141142",83,10,93,1
1060640,1094750,"B","1.15_ref",1,"141142",34,57,91,1
1116980,1154620,"A","1.16_ref",12,"141142",83,13,96,1
1171930,1194750,"B","2.1_ref",14,"141142",23,31,54,2
1207160,1229890,"A","2.2_ref",9,"141142",62,12,74,2
1239100,1251700,"B","2.3_ref",16,"141142",18,24,42,2
1263330,1271820,"A","2.4_ref",3,"141142",23,4,27,2
1281230,1297860,"B","2.5_ref",10,"141142",15,29,44,2
1320780,1334590,"A","2.6_ref",11,"141142",36,4,40,2
1341500,1360190,"B","2.7_ref",12,"141142",23,18,41,2
1395590,1410770,"A","2.8_ref",7,"141142",34,2,36,2
1424370,1439880,"B","2.9_ref",6,"141142",16,38,54,2
1489320,1503830,"A","2.10_ref",13,"141142",39,10,49,2
1513410,1530760,"B","2.11_ref",2,"141142",14,45,59,2
1542170,1562870,"A","2.12_ref",15,"141142",52,5,57,2
1571630,1601430,"B","2.13_ref",8,"141142",30,56,86,2
1612390,1626440,"A","2.14_ref",1,"141142",40,5,45,2
1637090,1655080,"B","2.15_ref",4,"141142",26,30,56,2
1673400,1687450,"A","2.16_ref",5,"141142",35,7,42,2
1698900,1714780,"B","3.1_ref",9,"141142",21,29,50,3
1725910,1743650,"A","3.2_ref",10,"141142",34,8,42,3
1754880,1774710,"B","3.3_ref",15,"141142",18,40,58,3
1790100,1802190,"A","3.4_ref",12,"141142",32,2,34,3
1814540,1824780,"B","3.5_ref",1,"141142",8,26,34,3
1847710,1860700,"A","3.6_ref",4,"141142",37,3,40,3
1877140,1887890,"B","3.7_ref",7,"141142",23,11,34,3
1899610,1910390,"A","3.8_ref",16,"141142",26,6,32,3
1921390,1933710,"B","3.9_ref",13,"141142",14,20,34,3
1961290,1979250,"A","3.10_ref",2,"141142",34,10,44,3
1997400,2019480,"B","3.11_ref",11,"141142",15,35,50,3
2032430,2043800,"A","3.12_ref",6,"141142",24,2,26,3
2061160,2074020,"B","3.13_ref",5,"141142",7,30,37,3
2082470,2091230,"A","3.14_ref",8,"141142",15,4,19,3
2130230,2146150,"B","3.15_ref",3,"141142",12,23,35,3
2155640,2167830,"A","3.16_ref",14,"141142",26,7,33,3
2183540,2192440,"B","4.1_ref",10,"141142",3,21,24,4
2209510,2226210,"A","4.2_ref",15,"141142",34,5,39,4
2236610,2247880,"B","4.3_ref",6,"141142",7,21,28,4
2266630,2275980,"A","4.4_ref",1,"141142",23,4,27,4
2284910,2296220,"B","4.5_ref",16,"141142",15,15,30,4
2312250,2318160,"A","4.6_ref",13,"141142",17,1,18,4
2333200,2341790,"B","4.7_ref",12,"141142",5,9,14,4
2353930,2365070,"A","4.8_ref",7,"141142",23,3,26,4
2373130,2384710,"B","4.9_ref",2,"141142",13,17,30,4
2418550,2431020,"A","4.10_ref",9,"141142",25,1,26,4
2447130,2458970,"B","4.11_ref",14,"141142",5,21,26,4
2474410,2484020,"A","4.12_ref",5,"141142",27,2,29,4
2494740,2502600,"B","4.13_ref",8,"141142",8,4,12,4
2519120,2530910,"A","4.14_ref",11,"141142",25,2,27,4
2537500,2557890,"B","4.15_ref",4,"141142",20,15,35,4
2568670,2574580,"A","4.16_ref",3,"141142",15,1,16,4
2591610,2599250,"B","5.1_ref",7,"141142",4,12,16,5
2618510,2625880,"A","5.2_ref",6,"141142",16,3,19,5
2638060,2648480,"B","5.3_ref",11,"141142",7,25,32,5
2676840,2685250,"A","5.4_ref",10,"141142",15,7,22,5
2691560,2719110,"B","5.5_ref",9,"141142",39,27,66,5
2742800,2752120,"A","5.6_ref",4,"141142",24,3,27,5
2769690,2775630,"B","5.7_ref",13,"141142",5,9,14,5
2790170,2803050,"A","5.8_ref",12,"141142",25,2,27,5
2810500,2822270,"B","5.9_ref",1,"141142",9,17,26,5
2844140,2851500,"A","5.10_ref",8,"141142",10,6,16,5
2863300,2877000,"B","5.11_ref",15,"141142",7,33,40,5
2885070,2892630,"A","5.12_ref",14,"141142",13,3,16,5
2913030,2936250,"B","5.13_ref",5,"141142",20,23,43,5
2951950,2961710,"A","5.14_ref",16,"141142",19,2,21,5
2974670,2982760,"B","5.15_ref",3,"141142",9,16,25,5
2996700,3005110,"A","5.16_ref",2,"141142",14,4,18,5
3010650,3018720,"B","6.1_ref",10,"141142",3,11,14,6
3036280,3051130,"A","6.2_ref",11,"141142",25,2,27,6
3062600,3067180,"B","6.3_ref",8,"141142",4,3,7,6
3079230,3091000,"A","6.4_ref",7,"141142",21,1,22,6
3108370,3122250,"B","6.5_ref",4,"141142",11,11,22,6
3134580,3142700,"A","6.6_ref",3,"141142",19,6,25,6
3152230,3161290,"B","6.7_ref",14,"141142",6,14,20,6
3166100,3171270,"A","6.8_ref",13,"141142",13,4,17,6
3178420,3188120,"B","6.9_ref",2,"141142",7,12,19,6
3198540,3206880,"A","6.10_ref",9,"141142",16,1,17,6
3218350,3228710,"B","6.11_ref",6,"141142",4,12,16,6
3244780,3257250,"A","6.12_ref",1,"141142",19,4,23,6
3266720,3274180,"B","6.13_ref",16,"141142",5,2,7,6
3299670,3309800,"A","6.14_ref",5,"141142",15,5,20,6
3316860,3322710,"B","6.15_ref",12,"141142",3,8,11,6
3337870,3348550,"A","6.16_ref",15,"141142",24,4,28,6
43070,114810,"B","1.1_ref",9,"143144",68,145,213,1
159920,178500,"A","1.2_ref",6,"143144",33,23,56,1
362770,390850,"B","1.3_ref",15,"143144",30,73,103,1
492770,528300,"A","1.4_ref",14,"143144",57,53,110,1
566840,586680,"B","1.5_ref",13,"143144",36,36,72,1
633210,661060,"A","1.6_ref",16,"143144",52,32,84,1
711660,733460,"B","1.7_ref",11,"143144",28,41,69,1
781650,816980,"A","1.8_ref",8,"143144",61,47,108,1
889070,897040,"B","1.9_ref",3,"143144",8,13,21,1
909900,1011050,"A","1.10_ref",10,"143144",212,130,342,1
1049570,1141650,"B","1.11_ref",5,"143144",122,187,309,1
1188270,1255640,"A","1.12_ref",4,"143144",123,101,224,1
1289010,1347440,"B","1.13_ref",7,"143144",31,148,179,1
1381150,1401360,"A","1.14_ref",2,"143144",42,27,69,1
1421050,1447460,"B","1.15_ref",1,"143144",25,68,93,1
1465960,1489560,"A","1.16_ref",12,"143144",46,35,81,1
1501890,1529920,"B","2.1_ref",14,"143144",27,65,92,2
1538080,1595760,"A","2.2_ref",9,"143144",107,79,186,2
1621900,1637900,"B","2.3_ref",16,"143144",9,40,49,2
1657930,1664720,"A","2.4_ref",3,"143144",10,3,13,2
1749240,1759020,"B","2.5_ref",10,"143144",12,23,35,2
1786960,1804240,"A","2.6_ref",11,"143144",29,19,48,2
1817910,1832390,"B","2.7_ref",12,"143144",14,14,28,2
1845280,1870570,"A","2.8_ref",7,"143144",54,28,82,2
1929200,1935780,"B","2.9_ref",6,"143144",6,4,10,2
1966640,1974960,"A","2.10_ref",13,"143144",15,9,24,2
1985870,1994380,"B","2.11_ref",2,"143144",5,21,26,2
2021170,2034180,"A","2.12_ref",15,"143144",23,15,38,2
2057390,2068100,"B","2.13_ref",8,"143144",12,28,40,2
2120620,2131230,"A","2.14_ref",1,"143144",16,12,28,2
2143500,2153600,"B","2.15_ref",4,"143144",10,25,35,2
2181970,2188640,"A","2.16_ref",5,"143144",5,4,9,2
2210150,2225570,"B","3.1_ref",9,"143144",25,27,52,3
2262760,2271690,"A","3.2_ref",10,"143144",13,9,22,3
2291110,2298460,"B","3.3_ref",15,"143144",9,9,18,3
2305870,2317670,"A","3.4_ref",12,"143144",29,17,46,3
2341080,2346540,"B","3.5_ref",1,"143144",7,4,11,3
2361080,2391200,"A","3.6_ref",4,"143144",51,48,99,3
2431690,2445850,"B","3.7_ref",7,"143144",13,17,30,3
2462690,2484050,"A","3.8_ref",16,"143144",44,27,71,3
2510820,2520100,"B","3.9_ref",13,"143144",11,10,21,3
2563790,2573000,"A","3.10_ref",2,"143144",7,13,20,3
2587780,2597670,"B","3.11_ref",11,"143144",7,21,28,3
2614530,2621610,"A","3.12_ref",6,"143144",3,4,7,3
2637520,2650300,"B","3.13_ref",5,"143144",8,3,11,3
2659080,2686660,"A","3.14_ref",8,"143144",53,23,76,3
2720040,2725010,"B","3.15_ref",3,"143144",5,4,9,3
2746630,2755910,"A","3.16_ref",14,"143144",10,13,23,3
2778450,2792010,"B","4.1_ref",10,"143144",9,17,26,4
2813500,2825800,"A","4.2_ref",15,"143144",8,14,22,4
2837710,2843980,"B","4.3_ref",6,"143144",10,4,14,4
2873000,2877880,"A","4.4_ref",1,"143144",5,5,10,4
2898470,2913670,"B","4.5_ref",16,"143144",17,16,33,4
2929050,2936010,"A","4.6_ref",13,"143144",4,4,8,4
2972920,2979530,"B","4.7_ref",12,"143144",5,12,17,4
3019400,3025820,"A","4.8_ref",7,"143144",4,9,13,4
3054610,3060100,"B","4.9_ref",2,"143144",5,15,20,4
3089440,3095810,"A","4.10_ref",9,"143144",6,6,12,4
3195580,3205050,"B","4.11_ref",14,"143144",9,16,25,4
3216340,3223460,"A","4.12_ref",5,"143144",2,3,5,4
3295280,3303380,"B","4.13_ref",8,"143144",5,9,14,4
3340820,3351740,"A","4.14_ref",11,"143144",11,6,17,4
3375310,3381720,"B","4.15_ref",4,"143144",10,10,20,4
3410760,3415040,"A","4.16_ref",3,"143144",2,4,6,4
3434270,3439960,"B","5.1_ref",7,"143144",8,5,13,5
3470830,3480240,"A","5.2_ref",6,"143144",3,8,11,5
3501450,3513190,"B","5.3_ref",11,"143144",10,26,36,5
3557270,3565930,"A","5.4_ref",10,"143144",7,5,12,5
3606850,3615100,"B","5.5_ref",9,"143144",8,5,13,5
3626510,3632350,"A","5.6_ref",4,"143144",6,5,11,5
3655070,3659750,"B","5.7_ref",13,"143144",9,3,12,5
3671150,3677230,"A","5.8_ref",12,"143144",8,5,13,5
3703940,3714370,"B","5.9_ref",1,"143144",7,7,14,5
3730250,3739690,"A","5.10_ref",8,"143144",8,7,15,5
3751220,3756440,"B","5.11_ref",15,"143144",7,9,16,5
3777080,3784220,"A","5.12_ref",14,"143144",11,6,17,5
3804830,3815440,"B","5.13_ref",5,"143144",5,5,10,5
3876840,3883930,"A","5.14_ref",16,"143144",10,3,13,5
3893860,3897990,"B","5.15_ref",3,"143144",2,3,5,5
3924490,3932070,"A","5.16_ref",2,"143144",10,7,17,5
3940730,3948920,"B","6.1_ref",10,"143144",8,8,16,6
3967460,3977600,"A","6.2_ref",11,"143144",8,6,14,6
3988770,3995460,"B","6.3_ref",8,"143144",4,15,19,6
4034430,4040080,"A","6.4_ref",7,"143144",8,4,12,6
4053550,4059740,"B","6.5_ref",4,"143144",9,9,18,6
4102850,4106840,"A","6.6_ref",3,"143144",3,4,7,6
4120480,4131340,"B","6.7_ref",14,"143144",13,20,33,6
4147080,4153770,"A","6.8_ref",13,"143144",3,5,8,6
4169510,4176680,"B","6.9_ref",2,"143144",9,10,19,6
4234390,4241080,"A","6.10_ref",9,"143144",5,3,8,6
4249780,4256500,"B","6.11_ref",6,"143144",6,4,10,6
4269110,4274500,"A","6.12_ref",1,"143144",5,2,7,6
4295340,4304950,"B","6.13_ref",16,"143144",8,8,16,6
4332040,4337210,"A","6.14_ref",5,"143144",3,2,5,6
4351950,4359860,"B","6.15_ref",12,"143144",12,12,24,6
4370170,4376270,"A","6.16_ref",15,"143144",2,8,10,6
38250,150380,"B","1.1_ref",9,"145146",103,177,280,1
170580,197660,"A","1.2_ref",6,"145146",57,31,88,1
224500,253130,"B","1.3_ref",15,"145146",29,63,92,1
269830,302150,"A","1.4_ref",14,"145146",44,43,87,1
313810,339700,"B","1.5_ref",13,"145146",29,44,73,1
366620,400420,"A","1.6_ref",16,"145146",52,47,99,1
419390,444420,"B","1.7_ref",11,"145146",27,59,86,1
469340,490200,"A","1.8_ref",8,"145146",43,16,59,1
531120,555510,"B","1.9_ref",3,"145146",34,45,79,1
565070,588340,"A","1.10_ref",10,"145146",44,23,67,1
652530,680040,"B","1.11_ref",5,"145146",44,55,99,1
694730,740200,"A","1.12_ref",4,"145146",90,52,142,1
762560,785210,"B","1.13_ref",7,"145146",20,46,66,1
800930,819030,"A","1.14_ref",2,"145146",14,21,35,1
831640,850140,"B","1.15_ref",1,"145146",10,33,43,1
862610,883460,"A","1.16_ref",12,"145146",44,21,65,1
898050,944140,"B","2.1_ref",14,"145146",58,70,128,2
953660,972560,"A","2.2_ref",9,"145146",42,18,60,2
993280,1013770,"B","2.3_ref",16,"145146",14,41,55,2
1025640,1035930,"A","2.4_ref",3,"145146",19,6,25,2
1070880,1080980,"B","2.5_ref",10,"145146",15,13,28,2
1115110,1124510,"A","2.6_ref",11,"145146",14,9,23,2
1133290,1141450,"B","2.7_ref",12,"145146",9,15,24,2
1157490,1170300,"A","2.8_ref",7,"145146",27,5,32,2
1232690,1244890,"B","2.9_ref",6,"145146",14,17,31,2
1391330,1424520,"A","2.10_ref",13,"145146",66,38,104,2
1440110,1451810,"B","2.11_ref",2,"145146",7,27,34,2
1497640,1508860,"A","2.12_ref",15,"145146",16,14,30,2
1532240,1570630,"B","2.13_ref",8,"145146",45,70,115,2
1584260,1596620,"A","2.14_ref",1,"145146",24,17,41,2
1616290,1624690,"B","2.15_ref",4,"145146",10,15,25,2
1654290,1660490,"A","2.16_ref",5,"145146",11,4,15,2
1671810,1685410,"B","3.1_ref",9,"145146",14,26,40,3
1702450,1710200,"A","3.2_ref",10,"145146",8,11,19,3
1728100,1738580,"B","3.3_ref",15,"145146",8,19,27,3
1752530,1757800,"A","3.4_ref",12,"145146",6,6,12,3
1785890,1797920,"B","3.5_ref",1,"145146",12,25,37,3
1816870,1822690,"A","3.6_ref",4,"145146",7,6,13,3
1851570,1861490,"B","3.7_ref",7,"145146",17,11,28,3
1903030,1934880,"A","3.8_ref",16,"145146",58,27,85,3
2053450,2065380,"B","3.9_ref",13,"145146",13,20,33,3
2085920,2094950,"A","3.10_ref",2,"145146",11,12,23,3
2128940,2148890,"B","3.11_ref",11,"145146",17,22,39,3
2162870,2169470,"A","3.12_ref",6,"145146",13,6,19,3
2186320,2192920,"B","3.13_ref",5,"145146",5,8,13,3
2202650,2219670,"A","3.14_ref",8,"145146",36,18,54,3
2351270,2359760,"B","3.15_ref",3,"145146",11,8,19,3
2385480,2398180,"A","3.16_ref",14,"145146",26,12,38,3
2402430,2410670,"B","4.1_ref",10,"145146",11,7,18,4
2468030,2481470,"A","4.2_ref",15,"145146",23,11,34,4
2530080,2538260,"B","4.3_ref",6,"145146",9,11,20,4
2630780,2640550,"A","4.4_ref",1,"145146",21,7,28,4
2696810,2721840,"B","4.5_ref",16,"145146",28,37,65,4
2748750,2757420,"A","4.6_ref",13,"145146",19,7,26,4
2863360,2870940,"B","4.7_ref",12,"145146",10,4,14,4
2894870,2904860,"A","4.8_ref",7,"145146",7,14,21,4
2929400,2936960,"B","4.9_ref",2,"145146",7,13,20,4
2966680,2974050,"A","4.10_ref",9,"145146",19,4,23,4
2978800,2990530,"B","4.11_ref",14,"145146",12,26,38,4
3004790,3014520,"A","4.12_ref",5,"145146",6,6,12,4
3074630,3096740,"B","4.13_ref",8,"145146",22,20,42,4
3142310,3150010,"A","4.14_ref",11,"145146",9,5,14,4
3228010,3233070,"B","4.15_ref",4,"145146",5,4,9,4
3268500,3274540,"A","4.16_ref",3,"145146",8,5,13,4
3281650,3289100,"B","5.1_ref",7,"145146",5,13,18,5
3309170,3316870,"A","5.2_ref",6,"145146",17,3,20,5
3504140,3509650,"B","5.3_ref",11,"145146",5,6,11,5
3550440,3556890,"A","5.4_ref",10,"145146",8,5,13,5
3583170,3590320,"B","5.5_ref",9,"145146",4,16,20,5
3607380,3614940,"A","5.6_ref",4,"145146",3,6,9,5
3668260,3681280,"B","5.7_ref",13,"145146",12,19,31,5
3699640,3705910,"A","5.8_ref",12,"145146",4,5,9,5
3738050,3746850,"B","5.9_ref",1,"145146",7,15,22,5
3804470,3812420,"A","5.10_ref",8,"145146",11,4,15,5
3831420,3845660,"B","5.11_ref",15,"145146",14,12,26,5
3880540,3908800,"A","5.12_ref",14,"145146",36,36,72,5
3967560,3977180,"B","5.13_ref",5,"145146",6,4,10,5
4015630,4026620,"A","5.14_ref",16,"145146",16,15,31,5
4032620,4039570,"B","5.15_ref",3,"145146",8,5,13,5
4062110,4066190,"A","5.16_ref",2,"145146",9,0,9,5
4081080,4088290,"B","6.1_ref",10,"145146",5,4,9,6
4145360,4155900,"A","6.2_ref",11,"145146",10,10,20,6
4168570,4175960,"B","6.3_ref",8,"145146",6,12,18,6
4186800,4193710,"A","6.4_ref",7,"145146",8,7,15,6
4210160,4214770,"B","6.5_ref",4,"145146",6,4,10,6
4247950,4253150,"A","6.6_ref",3,"145146",5,4,9,6
4280290,4289170,"B","6.7_ref",14,"145146",7,16,23,6
4303540,4309260,"A","6.8_ref",13,"145146",9,4,13,6
4334640,4341300,"B","6.9_ref",2,"145146",5,9,14,6
4372320,4379560,"A","6.10_ref",9,"145146",12,5,17,6
4395360,4402260,"B","6.11_ref",6,"145146",6,10,16,6
4425610,4434500,"A","6.12_ref",1,"145146",18,3,21,6
4605410,4611560,"B","6.13_ref",16,"145146",6,8,14,6
4624390,4629760,"A","6.14_ref",5,"145146",5,3,8,6
4641000,4646160,"B","6.15_ref",12,"145146",4,5,9,6
4661690,4669110,"A","6.16_ref",15,"145146",15,3,18,6
